Seconds since Launch,Total Requests,Requests Per Sec,Requests Okay,Requests Relayed,Requests Error
2.002674102783203,0,0.0,0,0,0
4.007486343383789,0,0.0,0,0,0
6.008162021636963,0,0.0,0,0,0
8.023998260498047,0,0.0,0,0,0
10.030604362487793,0,0.0,0,0,0
12.045270442962646,0,0.0,0,0,0
14.047800540924072,123,61.5,103,0,20
16.048668146133423,459,168.0,411,0,48
18.049819707870483,965,253.0,871,0,94
20.06543207168579,1533,284.0,1376,0,157
22.08104634284973,2248,357.5,2013,0,235
24.09656023979187,3170,461.0,2860,0,310
26.11226725578308,4209,519.5,3800,0,409
28.112271308898926,5353,572.0,4865,0,488
30.127925634384155,6805,726.0,6215,0,590
32.130717277526855,8357,776.0,7654,0,703
34.14624571800232,10094,868.5,9273,0,821
36.14633107185364,12037,971.5,11083,0,954
38.16191816329956,14136,1049.5,13059,0,1077
40.1775689125061,16436,1150.0,15218,0,1218
42.19309043884277,18845,1204.5,17472,0,1373
44.193130016326904,21285,1220.0,19768,0,1517
46.20168375968933,23952,1333.5,22257,0,1695
48.20275378227234,26616,1332.0,24759,0,1857
50.20437669754028,29524,1454.0,27482,0,2042
52.20439100265503,32723,1599.5,30483,0,2240
54.20469403266907,35940,1608.5,33508,0,2432
56.220367670059204,39217,1638.5,36556,0,2661
58.235925912857056,42748,1765.5,39871,0,2877
60.235944509506226,46335,1793.5,43250,0,3085
62.251617431640625,50132,1898.5,46822,0,3310
64.2555079460144,53804,1836.0,50251,0,3553
66.2605390548706,57674,1935.0,53887,0,3787
68.27617931365967,61631,1978.5,57614,0,4017
70.27622556686401,65777,2073.0,61509,0,4268
72.27848839759827,69967,2095.0,65459,0,4508
74.28071165084839,74114,2073.5,69343,0,4771
76.28169107437134,78391,2138.5,73368,0,5023
78.28235936164856,82647,2128.0,77359,0,5288
80.29209804534912,87175,2264.0,81653,0,5522
82.30484199523926,91893,2359.0,86083,0,5810
84.30929064750671,96642,2374.5,90558,0,6084
86.32482075691223,101356,2357.0,94967,0,6389
88.32496190071106,106240,2442.0,99547,0,6693
90.34077787399292,111334,2547.0,104292,0,7042
92.35304355621338,116379,2522.5,109018,0,7361
94.35377836227417,121536,2578.5,113837,0,7699
96.35390162467957,126874,2669.0,118815,0,8059
98.35651755332947,132801,2963.5,124367,0,8434
100.36958932876587,138616,2907.5,129784,0,8832
102.38530206680298,144475,2929.5,135231,0,9244
104.38844299316406,150416,2970.5,140784,0,9632
106.38884425163269,156334,2959.0,146293,0,10041
108.39234614372253,161927,2796.5,151515,0,10412
110.40400552749634,167851,2962.0,157063,0,10788
112.41022539138794,173795,2972.0,162612,0,11183
114.41066765785217,179686,2945.5,168141,0,11545
116.41712594032288,185545,2929.5,173607,0,11938
118.41990995407104,191413,2934.0,179094,0,12319
120.420907497406,197222,2904.5,184558,0,12664
122.42700600624084,203248,3013.0,190162,0,13086
124.42844557762146,208751,2751.5,195300,0,13451
126.43060564994812,214566,2907.5,200728,0,13838
128.43566799163818,220563,2998.5,206306,0,14257
130.43794131278992,226307,2872.0,211652,0,14655
132.44303250312805,232127,2910.0,217082,0,15045
134.45866084098816,238011,2942.0,222593,0,15418
136.4624445438385,243895,2942.0,228046,0,15849
138.46374201774597,249815,2960.0,233596,0,16219
140.46376967430115,255551,2868.0,238935,0,16616
142.46567463874817,261363,2906.0,244381,0,16982
144.47735023498535,267283,2960.0,249901,0,17382
146.48858642578125,272982,2849.5,255200,0,17782
148.4950830936432,278708,2863.0,260515,0,18193
150.49692106246948,284593,2942.5,266017,0,18576
152.49692153930664,290548,2977.5,271586,0,18962
154.51251435279846,296432,2942.0,277104,0,19328
156.51279020309448,302080,2824.0,282387,0,19693
158.51962661743164,307950,2935.0,287844,0,20106
160.52152395248413,313839,2944.5,293318,0,20521
162.52739095687866,319808,2984.5,298887,0,20921
164.52803134918213,325706,2949.0,304413,0,21293
166.5367772579193,331482,2888.0,309799,0,21683
168.55241060256958,337215,2866.5,315177,0,22038
170.5539927482605,343125,2955.0,320675,0,22450
172.56206512451172,348898,2886.5,326068,0,22830
174.56484007835388,354604,2853.0,331437,0,23167
176.56702733039856,357345,1370.5,333973,0,23372
178.57623624801636,362494,2574.5,338762,0,23732
180.58354902267456,368233,2869.5,344125,0,24108
182.58359098434448,373717,2742.0,349237,0,24480
184.5872621536255,378926,2604.5,354107,0,24819
186.58894157409668,384807,2940.5,359586,0,25221
188.5978171825409,390440,2816.5,364849,0,25591
190.6130769252777,396295,2927.5,370289,0,26006
192.61378931999207,402079,2892.0,375701,0,26378
194.6146936416626,407686,2803.5,380918,0,26768
196.61941957473755,413415,2864.5,386231,0,27184
198.62698984146118,419197,2891.0,391609,0,27588
200.63081288337708,424875,2839.0,396899,0,27976
202.6321256160736,430766,2945.5,402401,0,28365
204.63506412506104,436618,2926.0,407879,0,28739
206.63701939582825,442523,2952.5,413428,0,29095
208.65067529678345,448272,2874.5,418803,0,29469
210.65533781051636,454113,2920.5,424289,0,29824
212.66348719596863,459941,2914.0,429708,0,30233
214.66882967948914,465865,2962.0,435222,0,30643
216.67997646331787,471654,2894.5,440658,0,30996
218.69556665420532,477613,2979.5,446236,0,31377
220.71118640899658,483573,2980.0,451790,0,31783
222.7156229019165,489437,2932.0,457269,0,32168
224.71793150901794,495265,2914.0,462698,0,32567
226.71867728233337,501086,2910.5,468156,0,32930
228.71882343292236,506892,2903.0,473558,0,33334
230.73430228233337,512834,2971.0,479122,0,33712
232.74127840995789,518629,2897.5,484525,0,34104
234.74141550064087,524497,2934.0,489976,0,34521
236.75613498687744,530519,3011.0,495593,0,34926
238.75703835487366,536160,2820.5,500846,0,35314
240.7706434726715,542000,2920.0,506323,0,35677
242.7713406085968,547872,2936.0,511789,0,36083
244.77214765548706,553649,2888.5,517199,0,36450
246.78623175621033,559487,2919.0,522653,0,36834
248.791748046875,565355,2934.0,528121,0,37234
250.79676365852356,571273,2959.0,533634,0,37639
252.79758548736572,577002,2864.5,538999,0,38003
254.79807949066162,582810,2904.0,544401,0,38409
256.8031373023987,586453,1821.5,547804,0,38649
258.8088619709015,592384,2965.5,553362,0,39022
260.8098843097687,598273,2944.5,558854,0,39419
262.8098864555359,604088,2907.5,564303,0,39785
264.8110167980194,609881,2896.5,569749,0,40132
266.8124041557312,615772,2945.5,575252,0,40520
268.81288838386536,621490,2859.0,580555,0,40935
270.81298661231995,627178,2844.0,585904,0,41274
272.8131699562073,633048,2935.0,591397,0,41651
274.814302444458,638891,2921.5,596865,0,42026
276.8188154697418,644667,2888.0,602258,0,42409
278.8224003314972,650536,2934.5,607733,0,42803
280.82398319244385,656279,2871.5,613102,0,43177
282.8307201862335,662133,2927.0,618602,0,43531
284.8327901363373,667875,2871.0,623936,0,43939
286.8417491912842,673824,2974.5,629510,0,44314
288.84188318252563,679608,2892.0,634925,0,44683
290.8573794364929,685598,2995.0,640522,0,45076
292.86496448516846,691480,2941.0,646019,0,45461
294.86858320236206,697355,2937.5,651508,0,45847
296.86884903907776,703335,2990.0,657098,0,46237
298.876318693161,709191,2928.0,662541,0,46650
300.89056301116943,714973,2891.0,667946,0,47027
302.89057207107544,720834,2930.5,673436,0,47398
304.8918123245239,726350,2758.0,678622,0,47728
306.89930534362793,731989,2819.5,683882,0,48107
308.9004576206207,737765,2888.0,689271,0,48494
310.9006223678589,743695,2965.0,694796,0,48899
312.9162459373474,749771,3038.0,700479,0,49292
314.91716408729553,755639,2934.0,705944,0,49695
316.9171667098999,761411,2886.0,711324,0,50087
318.93292212486267,767046,2817.5,716543,0,50503
320.94532227516174,771434,2194.0,720646,0,50788
322.9607729911804,777278,2922.0,726123,0,51155
324.9615523815155,782899,2810.5,731388,0,51511
326.9621856212616,788805,2953.0,736877,0,51928
328.9625680446625,794780,2987.5,742476,0,52304
330.9679698944092,800485,2852.5,747769,0,52716
332.98354268074036,806342,2928.5,753197,0,53145
334.9955360889435,812144,2901.0,758621,0,53523
337.010381937027,817978,2917.0,764071,0,53907
339.02219820022583,823777,2899.5,769483,0,54294
341.0255925655365,829604,2913.5,774923,0,54681
343.029736995697,835464,2930.0,780404,0,55060
345.0416865348816,841419,2977.5,785981,0,55438
347.04640102386475,847255,2918.0,791437,0,55818
349.04750776290894,852950,2847.5,796728,0,56222
351.05949783325195,858868,2959.0,802236,0,56632
353.06853461265564,864761,2946.5,807741,0,57020
355.0695207118988,870472,2855.5,813063,0,57409
357.0714020729065,876412,2970.0,818605,0,57807
359.0807433128357,882320,2954.0,824142,0,58178
361.0829360485077,888005,2842.5,829451,0,58554
363.09061074256897,893744,2869.5,834819,0,58925
365.10356283187866,899263,2759.5,839989,0,59274
367.11575841903687,905169,2953.0,845503,0,59666
369.1262135505676,911195,3013.0,851105,0,60090
371.13004446029663,916400,2602.5,855963,0,60437
373.1443598270416,921867,2733.5,861076,0,60791
375.15839886665344,926989,2561.0,865838,0,61151
377.17339038848877,932790,2900.5,871243,0,61547
379.18130707740784,938426,2818.0,876500,0,61926
381.19386291503906,944252,2913.0,881933,0,62319
383.19504284858704,950009,2878.5,887277,0,62732
385.1965012550354,955834,2912.5,892746,0,63088
387.20459747314453,961577,2871.5,898124,0,63453
389.21954011917114,967392,2907.5,903553,0,63839
391.2250277996063,973036,2822.0,908844,0,64192
393.2261848449707,978736,2850.0,914171,0,64565
395.2362427711487,984733,2998.5,919755,0,64978
397.2365918159485,990570,2918.5,925196,0,65374
399.24833822250366,996458,2944.0,930694,0,65764
401.2483563423157,1002263,2902.5,936130,0,66133
403.25772428512573,1008045,2891.0,941533,0,66512
405.2642357349396,1013782,2868.5,946885,0,66897
407.2656273841858,1019560,2889.0,952299,0,67261
409.2679080963135,1025292,2866.0,957616,0,67676
411.2802679538727,1031254,2981.0,963170,0,68084
413.2952456474304,1037025,2885.5,968613,0,68412
415.3040015697479,1042987,2981.0,974185,0,68802
417.3053991794586,1048912,2962.5,979705,0,69207
419.30581068992615,1054817,2952.5,985200,0,69617
421.30739998817444,1060564,2873.5,990553,0,70011
423.30836939811707,1066335,2885.5,995943,0,70392
425.3100390434265,1072127,2896.0,1001343,0,70784
427.3106498718262,1077893,2883.0,1006736,0,71157
429.32463932037354,1083727,2917.0,1012217,0,71510
431.32479310035706,1089444,2858.5,1017565,0,71879
433.3404242992401,1095380,2968.0,1023116,0,72264
435.3408648967743,1101111,2865.5,1028467,0,72644
437.3473587036133,1106986,2937.5,1033959,0,73027
439.35062551498413,1112630,2822.0,1039245,0,73385
441.3625054359436,1118521,2945.5,1044754,0,73767
443.3713104724884,1124438,2958.5,1050280,0,74158
445.37276339530945,1130314,2938.0,1055770,0,74544
447.3728985786438,1136193,2939.5,1061230,0,74963
449.3884744644165,1142113,2960.0,1066746,0,75367
451.3884813785553,1147726,2806.5,1071975,0,75751
453.4043071269989,1153480,2877.0,1077342,0,76138
455.414098739624,1159380,2950.0,1082835,0,76545
457.423889875412,1165242,2931.0,1088307,0,76935
459.4239077568054,1170969,2863.5,1093674,0,77295
461.4268226623535,1176664,2847.5,1098973,0,77691
463.42727041244507,1182456,2896.0,1104413,0,78043
465.4344186782837,1188329,2936.5,1109893,0,78436
467.43718123435974,1194157,2914.0,1115367,0,78790
469.43981099128723,1199745,2794.0,1120608,0,79137
471.444043636322,1205560,2907.5,1126038,0,79522
473.453821182251,1211543,2991.5,1131654,0,79889
475.4545328617096,1217103,2780.0,1136843,0,80260
477.45462107658386,1222907,2902.0,1142254,0,80653
479.47015833854675,1228705,2899.0,1147672,0,81033
481.4701931476593,1234497,2896.0,1153084,0,81413
483.4758884906769,1239998,2750.5,1158197,0,81801
485.49133586883545,1245535,2768.5,1163360,0,82175
487.49284052848816,1251173,2819.0,1168608,0,82565
489.499223947525,1257011,2919.0,1174071,0,82940
491.5028347969055,1262691,2840.0,1179389,0,83302
493.5178463459015,1268606,2957.5,1184927,0,83679
495.532972574234,1274544,2969.0,1190482,0,84062
497.5337014198303,1280412,2934.0,1195977,0,84435
499.5392653942108,1286198,2893.0,1201389,0,84809
501.54687666893005,1292092,2947.0,1206879,0,85213
503.55070185661316,1298070,2989.0,1212453,0,85617
505.5612163543701,1303916,2923.0,1217927,0,85989
507.5621838569641,1310006,3045.0,1223615,0,86391
509.57247161865234,1316020,3007.0,1229226,0,86794
511.58181977272034,1321956,2968.0,1234767,0,87189
513.5967302322388,1327734,2889.0,1240155,0,87579
515.6006724834442,1333616,2941.0,1245686,0,87930
517.6010611057281,1339384,2884.0,1251041,0,88343
519.60271692276,1345263,2939.5,1256551,0,88712
521.6140689849854,1351106,2921.5,1262000,0,89106
523.6292579174042,1356929,2911.5,1267462,0,89467
525.6448864936829,1362899,2985.0,1273050,0,89849
527.6479022502899,1368742,2921.5,1278525,0,90217
529.6491532325745,1374524,2891.0,1283928,0,90596
531.6558072566986,1380311,2893.5,1289352,0,90959
533.658043384552,1386205,2947.0,1294852,0,91353
535.6581571102142,1392047,2921.0,1300321,0,91726
537.6722066402435,1397657,2805.0,1305528,0,92129
539.6736483573914,1403457,2900.0,1310940,0,92517
541.6769936084747,1409349,2946.0,1316466,0,92883
543.6775207519531,1415005,2828.0,1321743,0,93262
545.6801400184631,1420617,2806.0,1326983,0,93634
547.6803379058838,1426421,2902.0,1332420,0,94001
549.683087348938,1432259,2919.0,1337852,0,94407
551.6876080036163,1438102,2921.5,1343299,0,94803
553.7029118537903,1443683,2790.5,1348538,0,95145
555.7113003730774,1449460,2888.5,1353942,0,95518
557.7197952270508,1455363,2951.5,1359463,0,95900
559.720623254776,1461000,2818.5,1364727,0,96273
561.7338380813599,1466890,2945.0,1370288,0,96602
563.7385699748993,1472714,2912.0,1375761,0,96953
565.7398147583008,1478605,2945.5,1381254,0,97351
567.7407343387604,1484391,2893.0,1386665,0,97726
569.7563285827637,1490152,2880.5,1392058,0,98094
571.768132686615,1495877,2862.5,1397410,0,98467
573.7710828781128,1501608,2865.5,1402745,0,98863
575.7879092693329,1507440,2916.0,1408247,0,99193
577.789057970047,1513304,2932.0,1413737,0,99567
579.7891294956207,1519191,2943.5,1419229,0,99962
581.801619052887,1525100,2954.5,1424728,0,100372
583.8112261295319,1530679,2789.5,1429926,0,100753
585.812436580658,1536585,2953.0,1435429,0,101156
587.8140230178833,1542465,2940.0,1440933,0,101532
589.8269329071045,1548283,2909.0,1446374,0,101909
591.8294184207916,1554096,2906.5,1451820,0,102276
593.8449203968048,1560024,2964.0,1457342,0,102682
595.8449285030365,1565896,2936.0,1462819,0,103077
597.8582620620728,1571479,2791.5,1468016,0,103463
599.8624310493469,1577365,2943.0,1473508,0,103857
601.8668322563171,1583203,2919.0,1478943,0,104260