Seconds since Launch,Total Requests,Requests Per Sec,Requests Okay,Requests Relayed,Requests Error
2.017193555831909,0,0.0,0,0,0
4.022305488586426,46,23.0,41,0,5
6.037936687469482,264,109.0,234,0,30
8.053543090820312,660,198.0,584,0,76
10.06905722618103,1247,293.5,1110,0,137
12.06917953491211,1995,374.0,1769,0,226
14.08478856086731,2933,469.0,2598,0,335
16.087624311447144,4019,543.0,3559,0,460
18.103214979171753,5234,607.5,4641,0,593
20.118760585784912,6652,709.0,5888,0,764
22.118863105773926,8274,811.0,7318,0,956
24.134500980377197,10037,881.5,8898,0,1139
26.150086879730225,11952,957.5,10607,0,1345
28.156026601791382,14050,1049.0,12459,0,1591
30.171651124954224,16264,1107.0,14427,0,1837
32.18056917190552,18726,1231.0,16629,0,2097
34.19623255729675,21304,1289.0,18892,0,2412
36.19802141189575,23948,1322.0,21235,0,2713
38.198089599609375,26708,1380.0,23677,0,3031
40.213719844818115,29655,1473.5,26296,0,3359
42.229398250579834,32673,1509.0,28955,0,3718
44.23749589920044,35708,1517.5,31652,0,4056
46.24041748046875,39086,1689.0,34655,0,4431
48.24584674835205,42569,1741.5,37778,0,4791
50.255048751831055,46190,1810.5,41000,0,5190
52.262709856033325,49921,1865.5,44305,0,5616
54.27045035362244,53638,1858.5,47621,0,6017
56.27394151687622,57446,1904.0,50994,0,6452
58.27633309364319,61410,1982.0,54506,0,6904
60.2810959815979,65514,2052.0,58172,0,7342
62.28253412246704,69692,2089.0,61885,0,7807
64.28426361083984,74085,2196.5,65814,0,8271
66.2998354434967,78690,2302.5,69921,0,8769
68.30631518363953,83146,2228.0,73882,0,9264
70.31094312667847,87725,2289.5,77986,0,9739
72.31476020812988,92232,2253.5,81977,0,10255
74.33037972450256,96966,2367.0,86154,0,10812
76.33077931404114,101729,2381.5,90399,0,11330
78.3463191986084,106695,2483.0,94819,0,11876
80.34984230995178,111265,2285.0,98852,0,12413
82.3574230670929,113796,1265.5,101099,0,12697
84.36051297187805,116349,1276.5,103375,0,12974
86.36639952659607,121592,2621.5,107997,0,13595
88.37926626205444,127090,2749.0,112906,0,14184
90.38075232505798,132985,2947.5,118150,0,14835
92.39125728607178,138157,2586.0,122718,0,15439
94.39333319664001,143645,2744.0,127623,0,16022
96.40996503829956,149310,2832.5,132668,0,16642
98.41627812385559,155247,2968.5,137944,0,17303
100.43149018287659,161283,3018.0,143265,0,18018
102.43357348442078,166980,2848.5,148343,0,18637
104.43522524833679,172995,3007.5,153671,0,19324
106.44708752632141,178982,2993.5,158993,0,19989
108.45108580589294,184959,2988.5,164338,0,20621
110.45151448249817,190821,2931.0,169555,0,21266
112.45451736450195,196764,2971.5,174863,0,21901
114.45834136009216,202904,3070.0,180276,0,22628
116.4691710472107,208951,3023.5,185650,0,23301
118.47890520095825,214950,2999.5,190964,0,23986
120.49092650413513,220999,3024.5,196307,0,24692
122.49136686325073,227180,3090.5,201788,0,25392
124.50902700424194,233261,3040.5,207180,0,26081
126.51835751533508,239208,2973.5,212444,0,26764
128.5274634361267,245158,2975.0,217715,0,27443
130.52872467041016,251236,3039.0,223147,0,28089
132.5361828804016,257122,2943.0,228411,0,28711
134.53833651542664,263172,3025.0,233780,0,29392
136.5391595363617,269136,2982.0,239082,0,30054
138.54871344566345,275252,3058.0,244514,0,30738
140.55878162384033,281151,2949.5,249694,0,31457
142.57156324386597,287195,3022.0,255088,0,32107
144.5719244480133,293260,3032.5,260487,0,32773
146.57749485969543,299263,3001.5,265843,0,33420
148.59319758415222,305323,3030.0,271182,0,34141
150.60060620307922,311296,2986.5,276486,0,34810
152.6069836616516,317290,2997.0,281826,0,35464
154.6084280014038,323336,3023.0,287185,0,36151
156.61065578460693,329527,3095.5,292695,0,36832
158.62547659873962,335548,3010.5,298082,0,37466
160.63038992881775,341413,2932.5,303279,0,38134
162.63493633270264,347559,3073.0,308743,0,38816
164.64040350914001,353640,3040.5,314154,0,39486
166.6545910835266,359621,2990.5,319462,0,40159
168.65566325187683,365661,3020.0,324831,0,40830
170.66854238510132,371803,3071.0,330306,0,41497
172.68219566345215,378009,3103.0,335820,0,42189
174.68345737457275,384049,3020.0,341173,0,42876
176.69359922409058,390087,3019.0,346541,0,43546
178.6962559223175,396142,3027.5,351915,0,44227
180.69717264175415,402221,3039.5,357329,0,44892
182.71224546432495,408281,3030.0,362709,0,45572
184.71926832199097,414246,2982.5,367969,0,46277
186.7197344303131,420434,3094.0,373523,0,46911
188.72525119781494,426488,3027.0,378895,0,47593
190.7284712791443,432262,2887.0,383994,0,48268
192.73081994056702,438023,2880.5,389106,0,48917
194.74106740951538,444114,3045.5,394549,0,49565
196.74274969100952,450214,3050.0,399999,0,50215
198.75054287910461,456107,2946.5,405248,0,50859
200.7552661895752,461952,2922.5,410464,0,51488
202.7692654132843,467818,2933.0,415685,0,52133
204.78234767913818,473946,3064.0,421099,0,52847
206.78300404548645,479898,2976.0,426348,0,53550
208.78428101539612,485797,2949.5,431595,0,54202
210.79189562797546,491814,3008.5,436956,0,54858
212.80102396011353,498000,3093.0,442424,0,55576
214.80360627174377,503824,2912.0,447551,0,56273
216.80703806877136,509908,3042.0,452997,0,56911
218.82002329826355,516028,3060.0,458445,0,57583
220.83390641212463,522176,3074.0,463905,0,58271
222.8407802581787,528064,2944.0,469162,0,58902
224.84934043884277,534164,3050.0,474565,0,59599
226.8538429737091,540309,3072.5,480051,0,60258
228.86414742469788,546326,3008.5,485410,0,60916
230.8681480884552,552332,3003.0,490757,0,61575
232.87705826759338,558425,3046.5,496203,0,62222
234.88288688659668,564481,3028.0,501533,0,62948
236.89194512367249,570557,3038.0,506908,0,63649
238.89281058311462,576451,2947.0,512097,0,64354
240.8997631072998,582541,3045.0,517485,0,65056
242.90213179588318,588723,3091.0,522949,0,65774
244.90312814712524,594816,3046.5,528337,0,66479
246.9050121307373,600747,2965.5,533619,0,67128
248.91767477989197,606894,3073.5,539048,0,67846
250.92863082885742,612998,3052.0,544474,0,68524
252.94035625457764,618848,2925.0,549652,0,69196
254.9482274055481,624873,3012.5,555020,0,69853
256.9618353843689,630978,3052.5,560427,0,70551
258.9685628414154,637055,3038.5,565843,0,71212
260.97550797462463,643045,2995.0,571191,0,71854
262.9891896247864,648860,2907.5,576343,0,72517
264.9993004798889,654804,2972.0,581646,0,73158
267.0148060321808,660802,2999.0,586990,0,73812
269.0185146331787,666792,2995.0,592354,0,74438
271.02903175354004,672794,3001.0,597706,0,75088
273.0311737060547,678444,2825.0,602726,0,75718
275.03951621055603,683876,2716.0,607499,0,76377
277.05143880844116,689670,2897.0,612631,0,77039
279.0600736141205,695576,2953.0,617889,0,77687
281.0650601387024,701532,2978.0,623220,0,78312
283.069518327713,707463,2965.5,628478,0,78985
285.071453332901,713377,2957.0,633699,0,79678
287.07856035232544,719283,2953.0,638948,0,80335
289.0906550884247,725247,2982.0,644246,0,81001
291.0981013774872,731264,3008.5,649606,0,81658
293.1007647514343,737255,2995.5,654944,0,82311
295.10192465782166,743198,2971.5,660209,0,82989
297.1061315536499,749219,3010.5,665584,0,83635
299.1172137260437,755358,3069.5,671069,0,84289
301.118421792984,761155,2898.5,676203,0,84952
303.1210067272186,767139,2992.0,681505,0,85634
305.1425738334656,773155,3008.0,686845,0,86310
307.15768790245056,779218,3031.5,692272,0,86946
309.163494348526,785142,2962.0,697530,0,87612
311.1640393733978,790910,2884.0,702668,0,88242
313.16932129859924,796828,2959.0,707980,0,88848
315.1704285144806,802937,3054.5,713404,0,89533
317.17282152175903,808899,2981.0,718707,0,90192
319.1765079498291,814799,2950.0,723948,0,90851
321.1807527542114,820745,2973.0,729188,0,91557
323.1826813220978,826401,2828.0,734224,0,92177
325.1982173919678,832337,2968.0,739547,0,92790
327.2012438774109,838260,2961.5,744848,0,93412
329.2058913707733,844236,2988.0,750147,0,94089
331.21718740463257,850414,3089.0,755641,0,94773
333.21735095977783,856292,2939.0,760861,0,95431
335.2239968776703,862202,2955.0,766117,0,96085
337.22598361968994,868172,2985.0,771406,0,96766
339.2304849624634,874127,2977.5,776701,0,97426
341.24052143096924,879946,2909.5,781864,0,98082
343.2430739402771,886099,3076.5,787340,0,98759
345.2439341545105,892207,3054.0,792775,0,99432
347.2596800327301,898261,3027.0,798141,0,100120
349.259708404541,904195,2967.0,803425,0,100770
351.2744345664978,910220,3012.5,808783,0,101437
353.2800347805023,916310,3045.0,814231,0,102079
355.2889549732208,922113,2901.5,819366,0,102747
357.2901756763458,927799,2843.0,824458,0,103341
359.2920506000519,933689,2945.0,829704,0,103985
361.29205799102783,939740,3025.5,835047,0,104693
363.29325008392334,945651,2955.5,840296,0,105355
365.3080599308014,951552,2950.5,845535,0,106017
367.31072187423706,957617,3032.5,850952,0,106665
369.31597232818604,963754,3068.5,856438,0,107316
371.3204197883606,969475,2860.5,861495,0,107980
373.3305687904358,975527,3026.0,866867,0,108660
375.3348777294159,981582,3027.5,872276,0,109306
377.3362560272217,987547,2982.5,877577,0,109970
379.34633207321167,993542,2997.5,882880,0,110662
381.35693097114563,999474,2966.0,888142,0,111332
383.36550092697144,1005245,2885.5,893249,0,111996
385.37948536872864,1011099,2927.0,898454,0,112645
387.38217091560364,1016813,2857.0,903553,0,113260
389.3926475048065,1022757,2972.0,908848,0,113909
391.3930592536926,1028822,3032.5,914245,0,114577
393.40033888816833,1034768,2973.0,919519,0,115249
395.40622067451477,1040774,3003.0,924844,0,115930
397.41851687431335,1046833,3029.5,930201,0,116632
399.4211905002594,1052964,3065.5,935672,0,117292
401.424923658371,1059134,3085.0,941141,0,117993
403.43214082717896,1065062,2964.0,946409,0,118653
405.4355812072754,1071061,2999.5,951726,0,119335
407.44898557662964,1076993,2966.0,956997,0,119996
409.4522292613983,1083100,3053.5,962408,0,120692
411.467120885849,1089232,3066.0,967845,0,121387
413.46925020217896,1095710,3239.0,973590,0,122120
415.4833126068115,1101990,3140.0,979185,0,122805
417.4928889274597,1108216,3113.0,984722,0,123494
419.4947192668915,1114225,3004.5,990052,0,124173
421.4948537349701,1120276,3025.5,995491,0,124785
423.4974706172943,1126417,3070.5,1000927,0,125490
425.49935936927795,1132576,3079.5,1006438,0,126138
427.51380801200867,1138646,3035.0,1011841,0,126805
429.5214841365814,1145346,3350.0,1017786,0,127560
431.5252995491028,1151449,3051.5,1023257,0,128192
433.53147172927856,1157550,3050.5,1028662,0,128888
435.5356934070587,1163714,3082.0,1034101,0,129613
437.54008388519287,1169743,3014.5,1039477,0,130266
439.5496253967285,1175875,3066.0,1044938,0,130937
441.5611662864685,1182133,3129.0,1050464,0,131669
443.56502199172974,1188225,3046.0,1055899,0,132326
445.5781829357147,1194247,3011.0,1061227,0,133020
447.578462600708,1200219,2986.0,1066535,0,133684
449.58581018447876,1206493,3137.0,1072120,0,134373
451.59248638153076,1212508,3007.5,1077533,0,134975
453.60481572151184,1218541,3016.5,1082851,0,135690
455.6051642894745,1224674,3066.5,1088319,0,136355
457.6161103248596,1230604,2965.0,1093592,0,137012
459.6315836906433,1235842,2619.0,1098258,0,137584
461.634081363678,1241792,2975.0,1103578,0,138214
463.6429808139801,1247774,2991.0,1108912,0,138862
465.64334750175476,1253847,3036.5,1114299,0,139548
467.6545407772064,1259766,2959.5,1119593,0,140173
469.65524649620056,1265640,2937.0,1124843,0,140797
471.6596882343292,1271722,3041.0,1130268,0,141454
473.65974593162537,1277690,2984.0,1135556,0,142134
475.66058897972107,1283535,2922.5,1140747,0,142788
477.66879296302795,1289529,2997.0,1146072,0,143457
479.68440103530884,1295524,2997.5,1151356,0,144168
481.68440318107605,1301560,3018.0,1156733,0,144827
483.68556785583496,1308118,3279.0,1162567,0,145551
485.70135402679443,1315007,3444.5,1168704,0,146303
487.7167284488678,1321136,3064.5,1174105,0,147031
489.7169578075409,1327206,3035.0,1179510,0,147696
491.7233407497406,1333106,2950.0,1184731,0,148375
493.7234146595001,1338921,2907.5,1189895,0,149026
495.72539234161377,1344905,2992.0,1195193,0,149712
497.7276017665863,1351019,3057.0,1200618,0,150401
499.7279589176178,1357084,3032.5,1205997,0,151087
501.7325932979584,1363056,2986.0,1211316,0,151740
503.7482154369354,1369112,3028.0,1216654,0,152458
505.75396609306335,1375137,3012.5,1222038,0,153099
507.7642455101013,1381146,3004.5,1227419,0,153727
509.7662761211395,1387117,2985.5,1232693,0,154424
511.77370977401733,1393129,3006.0,1238000,0,155129
513.786942243576,1399270,3070.5,1243474,0,155796
515.7883551120758,1405419,3074.5,1248911,0,156508
517.7885646820068,1411401,2991.0,1254264,0,157137
519.7992696762085,1417476,3037.5,1259661,0,157815
521.8027496337891,1423541,3032.5,1265052,0,158489
523.804607629776,1429474,2966.5,1270333,0,159141
525.8063840866089,1435459,2992.5,1275607,0,159852
527.8076303005219,1441468,3004.5,1280967,0,160501
529.8094170093536,1447567,3049.5,1286347,0,161220
531.8179709911346,1453449,2941.0,1291535,0,161914
533.833295583725,1459533,3042.0,1296961,0,162572
535.8338432312012,1465638,3052.5,1302418,0,163220
537.8473660945892,1471771,3066.5,1307880,0,163891
539.8526883125305,1477634,2931.5,1313070,0,164564
541.8550450801849,1483632,2999.0,1318404,0,165228
543.8564975261688,1489789,3078.5,1323861,0,165928
545.8698370456696,1495772,2991.5,1329172,0,166600
547.8830778598785,1501707,2967.5,1334467,0,167240
549.8888976573944,1507822,3057.5,1339930,0,167892
551.8926665782928,1513545,2861.5,1344975,0,168570
553.9081950187683,1519494,2974.5,1350266,0,169228
555.9172117710114,1525504,3005.0,1355581,0,169923
557.9182405471802,1531629,3062.5,1361026,0,170603
559.9229073524475,1537779,3075.0,1366511,0,171268
561.9384958744049,1543746,2983.5,1371806,0,171940
563.938581943512,1549653,2953.5,1377064,0,172589
565.9545619487762,1555610,2978.5,1382369,0,173241
567.9701294898987,1561512,2951.0,1387568,0,173944
569.9838664531708,1567579,3033.5,1392979,0,174600
571.9956469535828,1573556,2988.5,1398303,0,175253
573.9969458580017,1579564,3004.0,1403688,0,175876
576.0102858543396,1585713,3074.5,1409180,0,176533
578.0146460533142,1591721,3004.0,1414510,0,177211
580.0241386890411,1597765,3022.0,1419853,0,177912
582.0256600379944,1603773,3004.0,1425199,0,178574
584.0294053554535,1609884,3055.5,1430650,0,179234
586.040543794632,1615830,2973.0,1435972,0,179858
588.0406243801117,1621742,2956.0,1441171,0,180571
590.0562829971313,1627810,3034.0,1446575,0,181235
592.0647294521332,1633759,2974.5,1451838,0,181921
594.074296951294,1639830,3035.5,1457227,0,182603
596.0753698348999,1645816,2993.0,1462605,0,183211
598.0834076404572,1651911,3047.5,1468028,0,183883
600.0860064029694,1657796,2942.5,1473293,0,184503
602.0866017341614,1663812,3008.0,1478631,0,185181
604.087334394455,1669817,3002.5,1483990,0,185827
606.0901033878326,1675786,2984.5,1489313,0,186473
608.095990896225,1681779,2996.5,1494614,0,187165
610.0979375839233,1687707,2964.0,1499862,0,187845
612.1016526222229,1693564,2928.5,1505094,0,188470
614.1023325920105,1699638,3037.0,1510492,0,189146
616.1180675029755,1705691,3026.5,1515812,0,189879
618.1286315917969,1711519,2914.0,1521019,0,190500
620.1341495513916,1717608,3044.5,1526405,0,191203
622.1360790729523,1723699,3045.5,1531825,0,191874
624.1410331726074,1729771,3036.0,1537220,0,192551
626.1557915210724,1735881,3055.0,1542688,0,193193
628.1683449745178,1741682,2900.5,1547837,0,193845
630.1795873641968,1747730,3024.0,1553253,0,194477
632.1823580265045,1753648,2959.0,1558501,0,195147
634.182998418808,1759779,3065.5,1563947,0,195832
636.1832749843597,1765904,3062.5,1569367,0,196537
638.1948630809784,1771892,2994.0,1574709,0,197183
640.1986970901489,1777723,2915.5,1579927,0,197796
642.2016599178314,1783703,2990.0,1585232,0,198471
644.2020647525787,1789732,3014.5,1590591,0,199141
646.2050976753235,1795766,3017.0,1595990,0,199776
648.2111525535583,1801762,2998.0,1601303,0,200459
650.2127223014832,1807638,2938.0,1606511,0,201127
652.2269945144653,1813718,3040.0,1611897,0,201821
654.2374293804169,1819878,3080.0,1617369,0,202509
656.2506654262543,1826014,3068.0,1622822,0,203192
658.2661683559418,1831875,2930.5,1628037,0,203838
660.2770330905914,1837808,2966.5,1633348,0,204460