Seconds since Launch,Total Requests,Requests Per Sec,Requests Okay,Requests Relayed,Requests Error
2.0144314765930176,0,0.0,0,0,0
4.016663312911987,0,0.0,0,0,0
6.0169854164123535,0,0.0,0,0,0
8.031378030776978,22,11.0,20,0,2
10.031991243362427,222,100.0,191,0,31
12.035759449005127,543,160.5,465,0,78
14.042150259017944,1016,236.5,887,0,129
16.042186498641968,1751,367.5,1523,0,228
18.05823040008545,2604,426.5,2269,0,335
20.073893785476685,3511,453.5,3079,0,432
22.07464289665222,4518,503.5,3966,0,552
24.07671618461609,5704,593.0,4998,0,706
26.09232759475708,6932,614.0,6073,0,859
28.107333183288574,8154,611.0,7144,0,1010
30.10746455192566,9452,649.0,8291,0,1161
32.11085653305054,10944,746.0,9608,0,1336
34.119486808776855,12509,782.5,11007,0,1502
36.129393100738525,13989,740.0,12360,0,1629
38.13151168823242,15662,836.5,13899,0,1763
40.131669759750366,17490,914.0,15561,0,1929
42.132856130599976,19455,982.5,17374,0,2081
44.14724040031433,21681,1113.0,19453,0,2228
46.15271997451782,24094,1206.5,21733,0,2361
48.16837787628174,26651,1278.5,24168,0,2483
50.17706751823425,29401,1375.0,26746,0,2655
52.18695855140686,32129,1364.0,29336,0,2793
54.197022676467896,35071,1471.0,32112,0,2959
56.20212459564209,38201,1565.0,35051,0,3150
58.20476222038269,41201,1500.0,37885,0,3316
60.20477628707886,44309,1554.0,40850,0,3459
62.22039175033569,47770,1730.5,44148,0,3622
64.22521257400513,51205,1717.5,47423,0,3782
66.2360246181488,54973,1884.0,51044,0,3929
68.23881793022156,58220,1623.5,54154,0,4066
70.24356412887573,60039,909.5,55894,0,4145
72.24640369415283,61622,791.5,57418,0,4204
74.24963092803955,65184,1781.0,60886,0,4298
76.25380229949951,69191,2003.5,64764,0,4427
78.26196074485779,73228,2018.5,68673,0,4555
80.27258157730103,77380,2076.0,72677,0,4703
82.27459383010864,81871,2245.5,77000,0,4871
84.27469182014465,85976,2052.5,80991,0,4985
86.27733612060547,89466,1745.0,84386,0,5080
88.28439950942993,93416,1975.0,88208,0,5208
90.29681348800659,97765,2174.5,92424,0,5341
92.30647802352905,102261,2248.0,96777,0,5484
94.31618547439575,106426,2082.5,100819,0,5607
96.31731843948364,110739,2156.5,105007,0,5732
98.32715821266174,115380,2320.5,109522,0,5858
100.33539462089539,120535,2577.5,114537,0,5998
102.34162139892578,125262,2363.5,119156,0,6106
104.34175610542297,130477,2607.5,124265,0,6212
106.34575867652893,135839,2681.0,129490,0,6349
108.35369682312012,140916,2538.5,134433,0,6483
110.36304259300232,145849,2466.5,139223,0,6626
112.37512612342834,150799,2475.0,144044,0,6755
114.3830235004425,155111,2156.0,148252,0,6859
116.39658999443054,159382,2135.5,152402,0,6980
118.40683674812317,164105,2361.5,156991,0,7114
120.41267037391663,168885,2390.0,161646,0,7239
122.42311191558838,174951,3033.0,167546,0,7405
124.43145251274109,179931,2490.0,172366,0,7565
126.44692897796631,185099,2584.0,177418,0,7681
128.45818495750427,190245,2573.0,182423,0,7822
130.4589123725891,194661,2208.0,186707,0,7954
132.47440648078918,200146,2742.5,192054,0,8092
134.47457695007324,204854,2354.0,196656,0,8198
136.4834394454956,210217,2681.5,201903,0,8314
138.4879183769226,215417,2600.0,206969,0,8448
140.48801183700562,220012,2297.5,211423,0,8589
142.49472188949585,224505,2246.5,215772,0,8733
144.49542379379272,228846,2170.5,219991,0,8855
146.50363636016846,233439,2296.5,224463,0,8976
148.5037124156952,239006,2783.5,229873,0,9133
150.50578379631042,244039,2516.5,234795,0,9244
152.517573595047,248756,2358.5,239403,0,9353
154.52195739746094,253429,2336.5,243957,0,9472
156.5329418182373,258967,2769.0,249355,0,9612
158.53396248817444,263933,2483.0,254184,0,9749
160.54955887794495,269084,2575.5,259195,0,9889
162.55399990081787,274427,2671.5,264417,0,10010
164.55550980567932,279723,2648.0,269578,0,10145
166.56521344184875,284781,2529.0,274492,0,10289
168.56594705581665,289735,2477.0,279306,0,10429
170.581467628479,294933,2599.0,284363,0,10570
172.58305382728577,299956,2511.5,289260,0,10696
174.5831813812256,305007,2525.5,294188,0,10819
176.59867668151855,309808,2400.5,298865,0,10943
178.5989170074463,314617,2404.5,303559,0,11058
180.60203623771667,320470,2926.5,309249,0,11221
182.61357641220093,325409,2469.5,314056,0,11353
184.61385655403137,329973,2282.0,318483,0,11490
186.61565375328064,334868,2447.5,323253,0,11615
188.6163728237152,338819,1975.5,327119,0,11700
190.6320836544037,343426,2303.5,331606,0,11820
192.64762043952942,348556,2565.0,336604,0,11952
194.6548764705658,352015,1729.5,339966,0,12049
196.66806745529175,357681,2833.0,345498,0,12183
198.6681685447693,362627,2473.0,350317,0,12310
200.66953921318054,367214,2293.5,354786,0,12428
202.6753318309784,372370,2578.0,359803,0,12567
204.68104720115662,377681,2655.5,364978,0,12703
206.6915316581726,382318,2318.5,369499,0,12819
208.69198775291443,387572,2627.0,374635,0,12937
210.69201946258545,392974,2701.0,379886,0,13088
212.7077488899231,395977,1501.5,382800,0,13177
214.7218098640442,401016,2519.5,387694,0,13322
216.72456741333008,405768,2376.0,392323,0,13445
218.7246334552765,410479,2355.5,396917,0,13562
220.73729753494263,415622,2571.5,401924,0,13698
222.73922514915466,419221,1799.5,405417,0,13804
224.7450156211853,423433,2106.0,409512,0,13921
226.75986647605896,428962,2764.5,414904,0,14058
228.77383089065552,434099,2568.5,419911,0,14188
230.7785041332245,438670,2285.5,424375,0,14295
232.78026175498962,443893,2611.5,429444,0,14449
234.7941153049469,449225,2666.0,434610,0,14615
236.79467105865479,454186,2480.5,439439,0,14747
238.8044810295105,458301,2057.5,443444,0,14857
240.8201072216034,463201,2450.0,448219,0,14982
242.82367491722107,467463,2131.0,452376,0,15087
244.8241949081421,471862,2199.5,456676,0,15186
246.83515167236328,476287,2212.5,460980,0,15307
248.84583854675293,480971,2342.0,465538,0,15433
250.8556046485901,486232,2630.5,470654,0,15578
252.87391328811646,491609,2688.5,475885,0,15724
254.87544059753418,497308,2849.5,481423,0,15885
256.89083790779114,502800,2746.0,486771,0,16029
258.9017114639282,508380,2790.0,492212,0,16168
260.90291810035706,513677,2648.5,497372,0,16305
262.90521001815796,518981,2652.0,502545,0,16436
264.91725182533264,524794,2906.5,508201,0,16593
266.9181568622589,530534,2870.0,513775,0,16759
268.92554688453674,536215,2840.5,519309,0,16906
270.9294214248657,541636,2710.5,524582,0,17054
272.9364082813263,547322,2843.0,530126,0,17196
274.94311451911926,552563,2620.5,535213,0,17350
276.95173621177673,558237,2837.0,540746,0,17491
278.9567165374756,561529,1646.0,543956,0,17573
280.9624011516571,564586,1528.5,546931,0,17655
282.9703893661499,568669,2041.5,550903,0,17766
284.98473143577576,573797,2564.0,555891,0,17906
286.98635029792786,579201,2702.0,561164,0,18037
288.98920154571533,584863,2831.0,566675,0,18188
290.9898989200592,588743,1940.0,570447,0,18296
292.99459958076477,591722,1489.5,573345,0,18377
295.01385402679443,597485,2881.5,578955,0,18530
297.0214693546295,600597,1556.0,581983,0,18614
299.0295433998108,605748,2575.5,587010,0,18738
301.04100942611694,611292,2772.0,592411,0,18881
303.04365968704224,616231,2469.5,597217,0,19014
305.04899764060974,621219,2494.0,602067,0,19152
307.05788230895996,626697,2739.0,607390,0,19307
309.06172585487366,632431,2867.0,612981,0,19450
311.0641224384308,637822,2695.5,618230,0,19592
313.0787389278412,643633,2905.5,623880,0,19753
315.07921147346497,647675,2021.0,627816,0,19859
317.0814542770386,653268,2796.5,633278,0,19990
319.087947845459,657763,2247.5,637661,0,20102
321.1027913093567,662036,2136.5,641824,0,20212
323.11262130737305,666831,2397.5,646480,0,20351
325.11427545547485,672114,2641.5,651623,0,20491
327.129763841629,676265,2075.5,655667,0,20598
329.1321439743042,681440,2587.5,660698,0,20742
331.136146068573,686731,2645.5,665852,0,20879
333.1408369541168,691734,2501.5,670716,0,21018
335.14794731140137,696088,2177.0,674949,0,21139
337.14844012260437,700910,2411.0,679645,0,21265
339.16356110572815,705595,2342.5,684187,0,21408
341.1693158149719,710987,2696.0,689429,0,21558
343.1746220588684,715941,2477.0,694247,0,21694
345.1884868144989,721366,2712.5,699521,0,21845
347.200058221817,726937,2785.5,704950,0,21987
349.2093663215637,733248,3155.5,711092,0,22156
351.22189950942993,739078,2915.0,716778,0,22300
353.2255423069,745111,3016.5,722646,0,22465
355.23741936683655,751107,2998.0,728476,0,22631
357.2474219799042,757369,3131.0,734597,0,22772
359.2494568824768,763066,2848.5,740134,0,22932
361.25017857551575,768977,2955.5,745899,0,23078
363.26232504844666,774869,2946.0,751660,0,23209
365.2713692188263,780960,3045.5,757588,0,23372
367.2825508117676,786898,2969.0,763387,0,23511
369.29278588294983,792937,3019.5,769262,0,23675
371.3019413948059,797164,2113.5,773381,0,23783
373.3104770183563,802196,2516.0,778263,0,23933
375.320517539978,807186,2495.0,783112,0,24074
377.3303875923157,811931,2372.5,787736,0,24195
379.33252120018005,817472,2770.5,793169,0,24303
381.34170937538147,823284,2906.0,798824,0,24460
383.3546314239502,829171,2943.5,804568,0,24603
385.3547999858856,833845,2337.0,809131,0,24714
387.36704444885254,837132,1643.5,812336,0,24796
389.3734335899353,842021,2444.5,817086,0,24935
391.37407302856445,847091,2535.0,822020,0,25071
393.37740182876587,852264,2586.5,827072,0,25192
395.38160514831543,856994,2365.0,831687,0,25307
397.3837785720825,862479,2742.5,837041,0,25438
399.39822363853455,867488,2504.5,841917,0,25571
401.41176676750183,871942,2227.0,846257,0,25685
403.41678071022034,876442,2250.0,850632,0,25810
405.41682505607605,879314,1436.0,853430,0,25884
407.42660880088806,884757,2721.5,858727,0,26030
409.42746782302856,888424,1833.5,862293,0,26131
411.44271874427795,892534,2055.0,866287,0,26247
413.4457709789276,896882,2174.0,870527,0,26355
415.44755005836487,902184,2651.0,875688,0,26496
417.4546184539795,907270,2543.0,880645,0,26625
419.45660853385925,911736,2233.0,884988,0,26748
421.4703001976013,916314,2289.0,889466,0,26848
423.4847803115845,921784,2735.0,894782,0,27002
425.49458360671997,927257,2736.5,900093,0,27164
427.49878096580505,930797,1770.0,903549,0,27248
429.51415634155273,935429,2316.0,908060,0,27369
431.51972341537476,940938,2754.5,913432,0,27506
433.5319678783417,946758,2910.0,919107,0,27651
435.5473141670227,952098,2670.0,924291,0,27807
437.557062625885,957622,2762.0,929662,0,27960
439.5586721897125,963161,2769.5,935053,0,28108
441.5712242126465,968906,2872.5,940659,0,28247
443.57614755630493,973423,2258.5,945038,0,28385
445.5844352245331,978557,2567.0,950047,0,28510
447.5931932926178,984121,2782.0,955452,0,28669
449.60156774520874,989230,2554.5,960428,0,28802
451.60675263404846,993821,2295.5,964884,0,28937
453.6213228702545,999240,2709.5,970160,0,29080
455.62900400161743,1004042,2401.0,974847,0,29195
457.6396098136902,1009352,2655.0,980019,0,29333
459.65312576293945,1012949,1798.5,983519,0,29430
461.67062044143677,1017526,2288.5,987955,0,29571
463.68144631385803,1022963,2718.5,993243,0,29720
465.68908286094666,1028538,2787.5,998678,0,29860
467.6912121772766,1033447,2454.5,1003446,0,30001
469.69210410118103,1038338,2445.5,1008211,0,30127
471.70112776756287,1042414,2038.0,1012193,0,30221
473.7147924900055,1046745,2165.5,1016416,0,30329
475.71501111984253,1051498,2376.5,1021039,0,30459
477.7247896194458,1057056,2779.0,1026439,0,30617
479.7330026626587,1062005,2474.5,1031244,0,30761
481.74677085876465,1067860,2927.5,1036949,0,30911
483.7615315914154,1073807,2973.5,1042737,0,31070
485.77357745170593,1079627,2910.0,1048423,0,31204
487.78521609306335,1085180,2776.5,1053815,0,31365
489.79271602630615,1090550,2685.0,1059037,0,31513
491.802081823349,1095501,2475.5,1063861,0,31640
493.8078622817993,1098162,1330.5,1066460,0,31702
495.8126118183136,1102645,2241.5,1070808,0,31837
497.8223133087158,1107603,2479.0,1075643,0,31960
499.83179211616516,1112073,2235.0,1079989,0,32084
501.84165620803833,1117223,2575.0,1084997,0,32226
503.8557231426239,1120083,1430.0,1087786,0,32297
505.865966796875,1124413,2165.0,1091988,0,32425
507.881552696228,1129668,2627.5,1097096,0,32572
509.89633560180664,1135651,2991.5,1102926,0,32725
511.89950489997864,1141061,2705.0,1108200,0,32861
513.9128949642181,1146538,2738.5,1113529,0,33009
515.9203848838806,1150950,2206.0,1117843,0,33107
517.9328901767731,1154195,1622.5,1121009,0,33186
519.9473524093628,1158705,2255.0,1125401,0,33304
521.9565904140472,1163491,2393.0,1130073,0,33418
523.957522392273,1168935,2722.0,1135379,0,33556
525.9583327770233,1174891,2978.0,1141193,0,33698
527.9597179889679,1179391,2250.0,1145575,0,33816
529.9687557220459,1183343,1976.0,1149431,0,33912
531.9813497066498,1189299,2978.0,1155232,0,34067
533.994264125824,1195233,2967.0,1161010,0,34223
536.0035169124603,1199693,2230.0,1165361,0,34332
538.0107102394104,1205219,2763.0,1170731,0,34488
540.0210406780243,1210711,2746.0,1176093,0,34618
542.031576871872,1216260,2774.5,1181515,0,34745
544.0342764854431,1221753,2746.5,1186875,0,34878
546.0414073467255,1226074,2160.5,1191101,0,34973
548.051228761673,1230912,2419.0,1195816,0,35096
550.0607161521912,1236833,2960.5,1201578,0,35255
552.0625128746033,1241780,2473.5,1206404,0,35376
554.0759618282318,1246777,2498.5,1211274,0,35503
556.0793232917786,1252520,2871.5,1216867,0,35653
558.0798923969269,1257399,2439.5,1221623,0,35776
560.0801718235016,1263209,2905.0,1227287,0,35922
562.0831265449524,1268070,2430.5,1232012,0,36058
564.0913248062134,1273489,2709.5,1237301,0,36188
566.1012151241302,1278958,2734.5,1242625,0,36333
568.1023280620575,1283978,2510.0,1247495,0,36483
570.1068589687347,1289404,2713.0,1252795,0,36609
572.1102495193481,1294659,2627.5,1257919,0,36740
574.1195042133331,1300365,2853.0,1263446,0,36919
576.1306517124176,1304917,2276.0,1267895,0,37022
578.1364605426788,1310216,2649.5,1273051,0,37165
580.1420850753784,1316120,2952.0,1278792,0,37328
582.1526100635529,1321245,2562.5,1283791,0,37454
584.1596148014069,1326482,2618.5,1288893,0,37589
586.1614909172058,1331844,2681.0,1294118,0,37726
588.169322013855,1337496,2826.0,1299618,0,37878
590.180507183075,1342989,2746.5,1304975,0,38014
592.181405544281,1347503,2257.0,1309377,0,38126
594.1887686252594,1352455,2476.0,1314209,0,38246
596.2034895420074,1358098,2821.5,1319700,0,38398
598.2079095840454,1362941,2421.5,1324420,0,38521
600.2108461856842,1367896,2477.5,1329243,0,38653
602.2169969081879,1372547,2325.5,1333767,0,38780
604.2176818847656,1377292,2372.5,1338394,0,38898
606.2318212985992,1382744,2726.0,1343696,0,39048
608.2393574714661,1388188,2722.0,1349023,0,39165
610.2482123374939,1393072,2442.0,1353779,0,39293
612.2631154060364,1398197,2562.5,1358769,0,39428
614.2727823257446,1403439,2621.0,1363888,0,39551
616.2828116416931,1408262,2411.5,1368563,0,39699
618.2922151088715,1413173,2455.5,1373352,0,39821
620.2934248447418,1418617,2722.0,1378657,0,39960
622.3021335601807,1424795,3089.0,1384644,0,40151
624.3146848678589,1430062,2633.5,1389752,0,40310
626.3247013092041,1435318,2628.0,1394891,0,40427
628.3270978927612,1440673,2677.5,1400104,0,40569
630.3299329280853,1445418,2372.5,1404721,0,40697
632.3377873897552,1450681,2631.5,1409834,0,40847
634.3495452404022,1455082,2200.5,1414108,0,40974
636.3504831790924,1460560,2739.0,1419446,0,41114
638.3636636734009,1466142,2791.0,1424879,0,41263
640.372652053833,1471092,2475.0,1429714,0,41378
642.3984706401825,1476316,2612.0,1434798,0,41518
644.4044690132141,1481928,2806.0,1440260,0,41668
646.4065744876862,1487327,2699.5,1445515,0,41812
648.4151456356049,1492514,2593.5,1450562,0,41952
650.424920797348,1498397,2941.5,1456301,0,42096
652.4417021274567,1504216,2909.5,1461962,0,42254
654.4454576969147,1509687,2735.5,1467286,0,42401
656.4574205875397,1514623,2468.0,1472084,0,42539
658.4640080928802,1519378,2377.5,1476714,0,42664
660.4660332202911,1524488,2555.0,1481699,0,42789
662.4797389507294,1530365,2938.5,1487434,0,42931
664.4918012619019,1535434,2534.5,1492367,0,43067
666.5070161819458,1540665,2615.5,1497440,0,43225
668.5137825012207,1546136,2735.5,1502754,0,43382
670.524425983429,1551792,2828.0,1508273,0,43519
672.5300273895264,1557488,2848.0,1513828,0,43660
674.5371692180634,1560634,1573.0,1516894,0,43740
676.5425093173981,1564090,1728.0,1520257,0,43833
678.5525977611542,1569835,2872.5,1525867,0,43968
680.5678598880768,1574551,2358.0,1530468,0,44083
682.5685033798218,1579907,2678.0,1535669,0,44238
684.5715491771698,1585747,2920.0,1541356,0,44391
686.5760400295258,1591003,2628.0,1546469,0,44534
688.5832271575928,1595769,2383.0,1551093,0,44676
690.588386297226,1600749,2490.0,1555940,0,44809
692.5963327884674,1604855,2053.0,1559944,0,44911
694.5971105098724,1609522,2333.5,1564475,0,45047
696.5987477302551,1613953,2215.5,1568808,0,45145
698.605105638504,1619039,2543.0,1573753,0,45286
700.6314458847046,1622780,1870.5,1577407,0,45373
702.6374247074127,1626496,1858.0,1581044,0,45452
704.6441774368286,1630322,1913.0,1584779,0,45543
706.6561291217804,1635326,2502.0,1589644,0,45682
708.6575102806091,1640610,2642.0,1594792,0,45818
710.6685507297516,1645343,2366.5,1599404,0,45939
712.678629398346,1650279,2468.0,1604215,0,46064
714.6803798675537,1655955,2838.0,1609743,0,46212
716.690122127533,1661657,2851.0,1615297,0,46360
718.6965990066528,1665801,2072.0,1619344,0,46457
720.7113761901855,1670693,2446.0,1624112,0,46581
722.7158498764038,1674927,2117.0,1628236,0,46691
724.7180387973785,1680370,2721.5,1633568,0,46802
726.7251732349396,1684707,2168.5,1637793,0,46914
728.7259442806244,1687809,1551.0,1640825,0,46984
730.7364127635956,1693454,2822.5,1646329,0,47125
732.7488539218903,1699017,2781.5,1651771,0,47246
734.7612638473511,1704457,2720.0,1657076,0,47381
736.7673227787018,1709184,2363.5,1661665,0,47519
738.7707285881042,1714628,2722.0,1666962,0,47666
740.7735970020294,1720627,2999.5,1672817,0,47810
742.78675365448,1725506,2439.5,1677555,0,47951
744.7890222072601,1730602,2548.0,1682506,0,48096
746.802003622055,1736168,2783.0,1687936,0,48232
748.8135509490967,1741310,2571.0,1692917,0,48393
750.8235466480255,1746584,2637.0,1698042,0,48542
752.8276596069336,1751579,2497.5,1702907,0,48672
754.8391737937927,1756265,2343.0,1707473,0,48792
756.8443737030029,1761526,2630.5,1712581,0,48945
758.8541100025177,1766171,2322.5,1717113,0,49058
760.8584673404694,1771266,2547.5,1722094,0,49172
762.8608784675598,1777181,2957.5,1727849,0,49332
764.8617181777954,1782159,2489.0,1732688,0,49471
766.8644614219666,1787745,2793.0,1738130,0,49615
768.8799993991852,1793604,2929.5,1743834,0,49770
770.891443490982,1799338,2867.0,1749429,0,49909
772.8928325176239,1804478,2570.0,1754431,0,50047
774.8990397453308,1809418,2470.0,1759228,0,50190
776.9050984382629,1815357,2969.5,1764997,0,50360
778.9111804962158,1820060,2351.5,1769580,0,50480
780.9240801334381,1824782,2361.0,1774184,0,50598
782.9341461658478,1830434,2826.0,1779701,0,50733
784.9467480182648,1835071,2318.5,1784217,0,50854
786.9475312232971,1839532,2230.5,1788583,0,50949
788.9495441913605,1844374,2421.0,1793305,0,51069
790.9527690410614,1849987,2806.5,1798770,0,51217
792.9577395915985,1855907,2960.0,1804551,0,51356
794.9642901420593,1860833,2463.0,1809357,0,51476
796.9685564041138,1864772,1969.5,1813211,0,51561
798.9692397117615,1868833,2030.5,1817179,0,51654
800.9823126792908,1873826,2496.5,1822047,0,51779
802.9829912185669,1879142,2658.0,1827216,0,51926
804.9901795387268,1884024,2441.0,1831961,0,52063
806.9909517765045,1889393,2684.5,1837182,0,52211
808.9921116828918,1894716,2661.5,1842379,0,52337
811.0025680065155,1900140,2712.0,1847649,0,52491
813.0174539089203,1904945,2402.5,1852329,0,52616
815.0240857601166,1909554,2304.5,1856830,0,52724
817.028037071228,1914975,2710.5,1862119,0,52856
819.0523142814636,1919938,2481.5,1866972,0,52966
821.056586265564,1924611,2336.5,1871525,0,53086
823.0700359344482,1930098,2743.5,1876854,0,53244
825.0760498046875,1935570,2736.0,1882181,0,53389
827.0841426849365,1940600,2515.0,1887081,0,53519
829.0902240276337,1945761,2580.5,1892096,0,53665
831.0974304676056,1951379,2809.0,1897599,0,53780
833.1116943359375,1956995,2808.0,1903049,0,53946
835.1136889457703,1962534,2769.5,1908417,0,54117
837.1171367168427,1967749,2607.5,1913491,0,54258
839.1253147125244,1972249,2250.0,1917878,0,54371
841.1286950111389,1978255,3003.0,1923724,0,54531
843.136958360672,1983466,2605.5,1928791,0,54675
845.1385803222656,1986309,1421.5,1931539,0,54770
847.1466431617737,1990141,1916.0,1935273,0,54868
849.150593996048,1994805,2332.0,1939825,0,54980
851.1647951602936,1999834,2514.5,1944737,0,55097
853.1720383167267,2004600,2383.0,1949387,0,55213
855.1795210838318,2010243,2821.5,1954879,0,55364
857.1859538555145,2015523,2640.0,1960020,0,55503
859.1918518543243,2020525,2501.0,1964887,0,55638
861.2012913227081,2025082,2278.5,1969323,0,55759
863.2149202823639,2030016,2467.0,1974126,0,55890
865.2258696556091,2035139,2561.5,1979120,0,56019
867.2300379276276,2040725,2793.0,1984554,0,56171
869.2432816028595,2045662,2468.5,1989365,0,56297
871.2495458126068,2050384,2361.0,1993963,0,56421
873.2538013458252,2055071,2343.5,1998528,0,56543
875.2540919780731,2059031,1980.0,2002394,0,56637
877.255850315094,2063767,2368.0,2007017,0,56750
879.265129327774,2069020,2626.5,2012134,0,56886
881.2738597393036,2072442,1711.0,2015455,0,56987
883.273877620697,2075982,1770.0,2018908,0,57074
885.2861142158508,2080739,2378.5,2023529,0,57210
887.2870800495148,2085675,2468.0,2028333,0,57342
889.2990875244141,2091106,2715.5,2033640,0,57466
891.3126485347748,2095428,2161.0,2037852,0,57576
893.3236908912659,2100304,2438.0,2042591,0,57713
895.3308596611023,2105121,2408.5,2047268,0,57853
897.3394649028778,2110020,2449.5,2052047,0,57973
899.3491089344025,2114855,2417.5,2056740,0,58115
901.3614926338196,2119798,2471.5,2061551,0,58247
903.3639762401581,2124226,2214.0,2065870,0,58356
905.3650815486908,2128944,2359.0,2070468,0,58476
907.3764793872833,2133595,2325.5,2074974,0,58621
909.385066986084,2138143,2274.0,2079379,0,58764
911.3889055252075,2142116,1986.5,2083274,0,58842
913.3947341442108,2146840,2362.0,2087860,0,58980
915.4055843353271,2151985,2572.5,2092875,0,59110
917.4065260887146,2155971,1993.0,2096762,0,59209
919.4095315933228,2160276,2152.5,2100949,0,59327
921.411669254303,2165570,2647.0,2106110,0,59460
923.414225101471,2170259,2344.5,2110665,0,59594
925.4244968891144,2176135,2938.0,2116417,0,59718
927.4278240203857,2180585,2225.0,2120762,0,59823
929.430006980896,2184146,1780.5,2124226,0,59920
931.4410471916199,2189906,2880.0,2129841,0,60065
933.4539172649384,2194947,2520.5,2134755,0,60192
935.4661676883698,2199101,2077.0,2138786,0,60315
937.470719575882,2204368,2633.5,2143910,0,60458
939.497752904892,2209162,2397.0,2148574,0,60588
941.5093050003052,2212902,1870.0,2152203,0,60699
943.5154044628143,2217737,2417.5,2156902,0,60835
945.5257596969604,2223217,2740.0,2162219,0,60998
947.534505367279,2227821,2302.0,2166693,0,61128
949.5452909469604,2232272,2225.5,2171026,0,61246
951.5473754405975,2237860,2794.0,2176481,0,61379
953.5523204803467,2243327,2733.5,2181792,0,61535
955.562658071518,2248576,2624.5,2186913,0,61663
957.5672717094421,2253464,2444.0,2191661,0,61803
959.5769028663635,2258502,2519.0,2196572,0,61930
961.5871155261993,2263868,2683.0,2201797,0,62071
963.6015565395355,2269570,2851.0,2207355,0,62215
965.6157052516937,2274038,2234.0,2211698,0,62340
967.6268076896667,2278032,1997.0,2215596,0,62436
969.6393928527832,2283453,2710.5,2220877,0,62576
971.6426796913147,2289154,2850.5,2226412,0,62742
973.661200761795,2294181,2513.5,2231315,0,62866
975.6739354133606,2299207,2513.0,2236215,0,62992
977.6752326488495,2304612,2702.5,2241466,0,63146
979.6769869327545,2309352,2370.0,2246074,0,63278
981.6863553524017,2314477,2562.5,2251031,0,63446
983.7003228664398,2320276,2899.5,2256662,0,63614
985.7123868465424,2326165,2944.5,2262402,0,63763
987.7214567661285,2331518,2676.5,2267620,0,63898
989.7353122234344,2336433,2457.5,2272410,0,64023
991.7376327514648,2341688,2627.5,2277526,0,64162
993.7555804252625,2346892,2602.0,2282605,0,64287
995.756231546402,2351391,2249.5,2286976,0,64415
997.7629868984222,2356489,2549.0,2291931,0,64558
999.7737901210785,2361649,2580.0,2296967,0,64682
1001.7778525352478,2366340,2345.5,2301550,0,64790
1003.7807841300964,2371453,2556.5,2306525,0,64928
1005.790590763092,2376234,2390.5,2311180,0,65054
1007.8115029335022,2382375,3070.5,2317171,0,65204
1009.8231754302979,2387233,2429.0,2321898,0,65335
1011.8313729763031,2391582,2174.5,2326137,0,65445
1013.8466455936432,2397103,2760.5,2331509,0,65594
1015.858882188797,2402363,2630.0,2336625,0,65738
1017.8607788085938,2407055,2346.0,2341183,0,65872
1019.8622405529022,2411417,2181.0,2345440,0,65977
1021.8744964599609,2416062,2322.5,2349963,0,66099
1023.8860330581665,2421917,2927.5,2355669,0,66248
1025.9032673835754,2426719,2401.0,2360361,0,66358
1027.9185359477997,2431677,2479.0,2365174,0,66503
1029.9293296337128,2437136,2729.5,2370490,0,66646
1031.9388210773468,2442786,2825.0,2375984,0,66802
1033.9503409862518,2446982,2098.0,2380053,0,66929
1035.9531733989716,2452410,2714.0,2385331,0,67079
1037.9689347743988,2457598,2594.0,2390370,0,67228
1039.9739871025085,2462649,2525.5,2395273,0,67376
1041.9816210269928,2467355,2353.0,2399844,0,67511
1043.9972567558289,2472646,2645.5,2404994,0,67652
1046.0021333694458,2477965,2659.5,2410178,0,67787
1048.0244822502136,2483069,2552.0,2415129,0,67940
1050.0342934131622,2488378,2654.5,2420302,0,68076
1052.047435760498,2493368,2495.0,2425158,0,68210
1054.0590789318085,2498704,2668.0,2430355,0,68349
1056.0648612976074,2503115,2205.5,2434644,0,68471
1058.0781972408295,2507978,2431.5,2439369,0,68609
1060.100427865982,2512600,2311.0,2443866,0,68734
1062.1031193733215,2518506,2953.0,2449609,0,68897
1064.1110534667969,2523160,2327.0,2454130,0,69030
1066.1285593509674,2527885,2362.5,2458751,0,69134
1068.1333532333374,2533081,2598.0,2463791,0,69290
1070.1417121887207,2537146,2032.5,2467750,0,69396
1072.1488161087036,2541591,2222.5,2472090,0,69501
1074.1528661251068,2546981,2695.0,2477317,0,69664
1076.1683902740479,2552744,2881.5,2482925,0,69819
1078.1788864135742,2557221,2238.5,2487281,0,69940
1080.1998705863953,2562487,2633.0,2492424,0,70063
1082.2012333869934,2567577,2545.0,2497379,0,70198
1084.2100565433502,2572942,2682.5,2502600,0,70342
1086.214561700821,2577626,2342.0,2507146,0,70480
1088.2286357879639,2582575,2474.5,2511962,0,70613
1090.2331371307373,2587854,2639.5,2517094,0,70760
1092.2344172000885,2592584,2365.0,2521706,0,70878
1094.2393200397491,2597294,2355.0,2526293,0,71001
1096.2510368824005,2601125,1915.5,2530033,0,71092
1098.259669303894,2605609,2242.0,2534389,0,71220
1100.2749116420746,2609733,2062.0,2538416,0,71317
1102.277464389801,2613973,2120.0,2542566,0,71407
1104.2861042022705,2618807,2417.0,2547267,0,71540
1106.2899565696716,2623710,2451.5,2552053,0,71657
1108.2979156970978,2628526,2408.0,2556736,0,71790
1110.3019239902496,2633334,2404.0,2561393,0,71941
1112.3115034103394,2638071,2368.5,2566018,0,72053
1114.3237164020538,2642073,2001.0,2569906,0,72167
1116.3254084587097,2648204,3065.5,2575893,0,72311
1118.3442208766937,2654022,2909.0,2581540,0,72482
1120.360836982727,2658859,2418.5,2586242,0,72617
1122.379511833191,2664283,2712.0,2591519,0,72764
1124.388221502304,2669694,2705.5,2596808,0,72886
1126.4055166244507,2674002,2154.0,2601001,0,73001
1128.4106743335724,2679137,2567.5,2605998,0,73139
1130.418611049652,2684466,2664.5,2611183,0,73283
1132.4203553199768,2689824,2679.0,2616405,0,73419
1134.433352470398,2695105,2640.5,2621552,0,73553
1136.448852777481,2700164,2529.5,2626497,0,73667
1138.4584395885468,2705685,2760.5,2631874,0,73811
1140.473618030548,2711524,2919.5,2637561,0,73963
1142.4837996959686,2716235,2355.5,2642150,0,74085
1144.4851434230804,2721689,2727.0,2647474,0,74215
1146.4886538982391,2727267,2789.0,2652912,0,74355
1148.5011270046234,2732857,2795.0,2658357,0,74500
1150.5057277679443,2737795,2469.0,2663175,0,74620
1152.5146403312683,2742123,2164.0,2667395,0,74728
1154.5205788612366,2747920,2898.5,2673032,0,74888
1156.5209000110626,2753339,2709.5,2678301,0,75038
1158.5228073596954,2758002,2331.5,2682844,0,75158
1160.5423605442047,2762966,2482.0,2687668,0,75298
1162.5505633354187,2768113,2573.5,2692686,0,75427
1164.5661883354187,2773598,2742.5,2698031,0,75567
1166.5717470645905,2778498,2450.0,2702772,0,75726
1168.5850150585175,2783546,2524.0,2707676,0,75870
1170.5984802246094,2789098,2776.0,2713082,0,76016
1172.6008818149567,2793968,2435.0,2717807,0,76161
1174.6072659492493,2798221,2126.5,2721946,0,76275
1176.6258254051208,2803010,2394.5,2726605,0,76405
1178.627496957779,2807223,2106.5,2730708,0,76515
1180.6456537246704,2811891,2334.0,2735257,0,76634
1182.6589090824127,2815956,2032.5,2739224,0,76732
1184.6639475822449,2821224,2634.0,2744342,0,76882
1186.6686635017395,2826619,2697.5,2749585,0,77034
1188.6748762130737,2831299,2340.0,2754152,0,77147
1190.6763846874237,2835687,2194.0,2758429,0,77258
1192.685982465744,2840945,2629.0,2763546,0,77399
1194.6868407726288,2846533,2794.0,2768990,0,77543
1196.6937851905823,2851100,2283.5,2773444,0,77656
1198.7007160186768,2854481,1690.5,2776734,0,77747
1200.7076573371887,2860342,2930.5,2782438,0,77904
1202.7129786014557,2863186,1422.0,2785217,0,77969
1204.7334105968475,2868132,2473.0,2790017,0,78115
1206.743806362152,2872018,1943.0,2793790,0,78228
1208.7576885223389,2877499,2740.5,2799131,0,78368
1210.7649657726288,2882585,2543.0,2804088,0,78497
1212.7792296409607,2887010,2212.5,2808395,0,78615
1214.7946405410767,2891037,2013.5,2812317,0,78720
1216.807933330536,2896036,2499.5,2817187,0,78849
1218.8134679794312,2900312,2138.0,2821365,0,78947
1220.821219444275,2905541,2614.5,2826453,0,79088
1222.8258509635925,2910394,2426.5,2831165,0,79229
1224.8404309749603,2915732,2669.0,2836362,0,79370
1226.8417851924896,2920204,2236.0,2840719,0,79485
1228.8575699329376,2925297,2546.5,2845679,0,79618
1230.8592569828033,2930458,2580.5,2850689,0,79769
1232.8692502975464,2936070,2806.0,2856136,0,79934
1234.8792474269867,2940361,2145.5,2860302,0,80059
1236.8936939239502,2945795,2717.0,2865588,0,80207
1238.895114183426,2951263,2734.0,2870917,0,80346
1240.9057366847992,2956100,2418.5,2875640,0,80460
1242.9066247940063,2960778,2339.0,2880192,0,80586
1244.913676738739,2966359,2790.5,2885612,0,80747
1246.9187128543854,2971565,2603.0,2890670,0,80895
1248.9283542633057,2976429,2432.0,2895388,0,81041
1250.9386241436005,2981078,2324.5,2899894,0,81184
1252.9542407989502,2986409,2665.5,2905071,0,81338
1254.9599723815918,2992070,2830.5,2910562,0,81508
1256.9640457630157,2995920,1925.0,2914305,0,81615
1258.9785933494568,3000435,2257.5,2918687,0,81748
1260.9997522830963,3005777,2671.0,2923877,0,81900
1263.0075595378876,3010890,2556.5,2928860,0,82030
1265.0082387924194,3015181,2145.5,2933035,0,82146
1267.0159611701965,3019409,2114.0,2937141,0,82268
1269.028486251831,3024666,2628.5,2942258,0,82408
1271.030112504959,3030209,2771.5,2947649,0,82560
1273.0395607948303,3034774,2282.5,2952089,0,82685
1275.0525887012482,3039047,2136.5,2956244,0,82803
1277.0551249980927,3042201,1577.0,2959307,0,82894
1279.0617952346802,3044990,1394.5,2962029,0,82961
1281.0648427009583,3050549,2779.5,2967435,0,83114
1283.0779147148132,3055877,2664.0,2972625,0,83252
1285.087347984314,3060063,2093.0,2976712,0,83351
1287.096664905548,3063672,1804.5,2980227,0,83445
1289.0991966724396,3067996,2162.0,2984433,0,83563
1291.1049191951752,3071355,1679.5,2987707,0,83648
1293.1156859397888,3076412,2528.5,2992635,0,83777
1295.1167418956757,3079971,1779.5,2996105,0,83866
1297.1212511062622,3084150,2089.5,3000176,0,83974
1299.1280629634857,3089011,2430.5,3004907,0,84104
1301.1284279823303,3094329,2659.0,3010076,0,84253
1303.1322979927063,3099661,2666.0,3015254,0,84407
1305.1452379226685,3105581,2960.0,3021003,0,84578
1307.1601989269257,3110402,2410.5,3025689,0,84713
1309.1744132041931,3115822,2710.0,3030966,0,84856
1311.1858041286469,3119481,1829.5,3034517,0,84964
1313.1925871372223,3124983,2751.0,3039881,0,85102
1315.205327987671,3130584,2800.5,3045330,0,85254
1317.208642244339,3136162,2789.0,3050772,0,85390
1319.2172420024872,3141011,2424.5,3055494,0,85517
1321.2213325500488,3146088,2538.5,3060425,0,85663
1323.2353689670563,3150554,2233.0,3064776,0,85778
1325.2396185398102,3155260,2353.0,3069354,0,85906
1327.2555396556854,3160290,2515.0,3074242,0,86048
1329.2575900554657,3165266,2488.0,3079087,0,86179
1331.2730224132538,3170558,2646.0,3084263,0,86295
1333.2909719944,3175993,2717.5,3089533,0,86460
1335.2991216182709,3182175,3091.0,3095536,0,86639
1337.3029446601868,3187264,2544.5,3100495,0,86769
1339.3066320419312,3192057,2396.5,3105164,0,86893
1341.3075251579285,3196102,2022.5,3109087,0,87015
1343.315588235855,3201170,2534.0,3114036,0,87134
1345.3226132392883,3205865,2347.5,3118608,0,87257
1347.3383219242096,3210923,2529.0,3123517,0,87406
1349.3405139446259,3215625,2351.0,3128076,0,87549
1351.3522350788116,3221202,2788.5,3133512,0,87690
1353.3636078834534,3226295,2546.5,3138463,0,87832
1355.375854730606,3230682,2193.5,3142734,0,87948
1357.3805420398712,3235710,2514.0,3147629,0,88081
1359.407821893692,3240414,2352.0,3152211,0,88203
1361.412422657013,3245881,2733.5,3157546,0,88335
1363.428130865097,3250854,2486.5,3162392,0,88462
1365.434733390808,3256306,2726.0,3167696,0,88610
1367.4503076076508,3262234,2964.0,3173466,0,88768
1369.4562203884125,3267921,2843.5,3178987,0,88934
1371.4604449272156,3273685,2882.0,3184600,0,89085
1373.464971780777,3278326,2320.5,3189131,0,89195
1375.46715092659,3283690,2682.0,3194360,0,89330
1377.476450920105,3288876,2593.0,3199413,0,89463
1379.4895753860474,3293722,2423.0,3204126,0,89596
1381.496824979782,3298431,2354.5,3208712,0,89719
1383.50843167305,3303512,2540.5,3213642,0,89870
1385.5156981945038,3308922,2705.0,3218917,0,90005
1387.536983013153,3314249,2663.5,3224088,0,90161
1389.5405566692352,3318969,2360.0,3228668,0,90301
1391.552461862564,3324456,2743.5,3234021,0,90435
1393.555371761322,3330330,2937.0,3239730,0,90600
1395.5603530406952,3335957,2813.5,3245212,0,90745
1397.5735096931458,3341459,2751.0,3250557,0,90902
1399.5865395069122,3346160,2350.5,3255128,0,91032
1401.5915229320526,3350972,2406.0,3259801,0,91171
1403.606873035431,3356848,2938.0,3265514,0,91334
1405.620335817337,3362341,2746.5,3270886,0,91455
1407.6329004764557,3367423,2541.0,3275826,0,91597
1409.6468441486359,3372919,2748.0,3281180,0,91739
1411.6588196754456,3378263,2672.0,3286375,0,91888
1413.6664214134216,3382861,2299.0,3290847,0,92014
1415.6746127605438,3387698,2418.5,3295542,0,92156
1417.6770749092102,3393602,2952.0,3301299,0,92303
1419.6849400997162,3396690,1544.0,3304310,0,92380
1421.6881811618805,3399594,1452.0,3307136,0,92458
1423.7034902572632,3403663,2034.5,3311112,0,92551
1425.7166242599487,3409340,2838.5,3316653,0,92687
1427.7252991199493,3414717,2688.5,3321894,0,92823
1429.7397804260254,3417984,1633.5,3325078,0,92906
1431.7504017353058,3423130,2573.0,3330083,0,93047
1433.755808353424,3429417,3143.5,3336230,0,93187
1435.7603154182434,3434727,2655.0,3341388,0,93339
1437.765882730484,3439635,2454.0,3346170,0,93465
1439.7669298648834,3444659,2512.0,3351079,0,93580
1441.7705326080322,3450087,2714.0,3356358,0,93729
1443.7715890407562,3454594,2253.5,3360762,0,93832
1445.7803835868835,3459598,2502.0,3365624,0,93974
1447.7832539081573,3464044,2223.0,3369959,0,94085
1449.7891285419464,3469310,2633.0,3375072,0,94238
1451.796591758728,3474857,2773.5,3380471,0,94386
1453.7997057437897,3479983,2563.0,3385435,0,94548
1455.8077502250671,3485021,2519.0,3390339,0,94682
1457.8218984603882,3489658,2318.5,3394860,0,94798
1459.8342242240906,3494192,2267.0,3399276,0,94916
1461.835676908493,3499413,2610.5,3404358,0,95055
1463.8504800796509,3505082,2834.5,3409883,0,95199
1465.8507828712463,3511038,2978.0,3415681,0,95357
1467.8624489307404,3516601,2781.5,3421107,0,95494
1469.8706529140472,3520891,2145.0,3425278,0,95613
1471.8760538101196,3525854,2481.5,3430108,0,95746
1473.8793060779572,3531580,2863.0,3435699,0,95881
1475.889258146286,3536501,2460.5,3440499,0,96002
1477.895231962204,3541896,2697.5,3445754,0,96142
1479.898176908493,3546606,2355.0,3450333,0,96273
1481.8993589878082,3552119,2756.5,3455703,0,96416
1483.9023933410645,3557450,2665.5,3460907,0,96543
1485.903326034546,3563190,2870.0,3466479,0,96711
1487.9058911800385,3568037,2423.5,3471210,0,96827
1489.9207923412323,3572987,2475.0,3476036,0,96951
1491.9294302463531,3578913,2963.0,3481817,0,97096
1493.9368197917938,3584700,2893.5,3487458,0,97242
1495.9504044055939,3590054,2677.0,3492700,0,97354
1497.9574217796326,3595123,2534.5,3497636,0,97487
1499.9620547294617,3600473,2675.0,3502838,0,97635
1501.9693381786346,3606298,2912.5,3508496,0,97802
1503.984213590622,3611242,2472.0,3513336,0,97906
1505.987601518631,3616391,2574.5,3518356,0,98035
1507.991467475891,3621881,2745.0,3523709,0,98172
1509.9934775829315,3627713,2916.0,3529404,0,98309
1512.0010197162628,3632341,2314.0,3533922,0,98419
1514.010110616684,3637378,2518.5,3538815,0,98563
1516.012702703476,3643241,2931.5,3544506,0,98735
1518.022908449173,3648144,2451.5,3549290,0,98854
1520.036057472229,3653257,2556.5,3554262,0,98995
1522.0509006977081,3659078,2910.5,3559943,0,99135
1524.0653524398804,3664684,2803.0,3565401,0,99283
1526.0703675746918,3669896,2606.0,3570484,0,99412
1528.08514046669,3674704,2404.0,3575146,0,99558
1530.0924077033997,3680064,2680.0,3580358,0,99706
1532.1072208881378,3685021,2478.5,3585187,0,99834
1534.1170499324799,3690072,2525.5,3590111,0,99961
1536.1467554569244,3694940,2434.0,3594843,0,100097
1538.15367603302,3699765,2412.5,3599543,0,100222
1540.1540713310242,3705288,2761.5,3604920,0,100368
1542.1697022914886,3710835,2773.5,3610317,0,100518
1544.1724808216095,3715955,2560.0,3615295,0,100660
1546.183725118637,3720763,2404.0,3619991,0,100772
1548.1884589195251,3726156,2696.5,3625265,0,100891
1550.2040312290192,3730662,2253.0,3629615,0,101047
1552.2060370445251,3735292,2315.0,3634124,0,101168
1554.207058429718,3739106,1907.0,3637826,0,101280
1556.2223274707794,3743890,2392.0,3642492,0,101398
1558.2332191467285,3749665,2887.5,3648093,0,101572
1560.2417104244232,3754409,2372.0,3652710,0,101699
1562.2550365924835,3759530,2560.5,3657706,0,101824
1564.2647824287415,3762948,1709.0,3661045,0,101903
1566.2775180339813,3768130,2591.0,3666091,0,102039
1568.2802004814148,3773167,2518.5,3670995,0,102172
1570.2849185466766,3778821,2827.0,3676500,0,102321
1572.2960712909698,3784405,2792.0,3681923,0,102482
1574.296345949173,3789094,2344.5,3686488,0,102606
1576.3029680252075,3792301,1603.5,3689616,0,102685
1578.310623884201,3797345,2522.0,3694532,0,102813
1580.3220694065094,3802728,2691.5,3699795,0,102933
1582.3318977355957,3807538,2405.0,3704471,0,103067
1584.3461606502533,3812678,2570.0,3709457,0,103221
1586.3529014587402,3817922,2622.0,3714566,0,103356
1588.3664166927338,3823544,2811.0,3720037,0,103507
1590.3694558143616,3828049,2252.5,3724428,0,103621
1592.3818027973175,3832836,2393.5,3729097,0,103739
1594.384553194046,3837916,2540.0,3734055,0,103861
1596.3997719287872,3843243,2663.5,3739236,0,104007
1598.4039211273193,3847463,2110.0,3743352,0,104111
1600.406089067459,3852258,2397.5,3748011,0,104247
1602.4173998832703,3857682,2712.0,3753284,0,104398
1604.4321920871735,3863045,2681.5,3758499,0,104546
1606.4408535957336,3868590,2772.5,3763890,0,104700
1608.4476425647736,3873445,2427.5,3768624,0,104821
1610.4586069583893,3878336,2445.5,3773376,0,104960
1612.4706473350525,3883824,2744.0,3778739,0,105085
1614.4820878505707,3889139,2657.5,3783906,0,105233
1616.4962258338928,3893472,2166.5,3788117,0,105355
1618.5072841644287,3897826,2177.0,3792352,0,105474
1620.519377231598,3902592,2383.0,3797002,0,105590
1622.5202777385712,3907675,2541.5,3801979,0,105696
1624.5214533805847,3912448,2386.5,3806636,0,105812
1626.5337309837341,3917383,2467.5,3811426,0,105957
1628.5454289913177,3922946,2781.5,3816847,0,106099
1630.5561192035675,3928520,2787.0,3822282,0,106238
1632.5655188560486,3931973,1726.5,3825648,0,106325
1634.576679944992,3936317,2172.0,3829887,0,106430
1636.5886416435242,3941828,2755.5,3835250,0,106578
1638.600520849228,3945595,1883.5,3838906,0,106689
1640.6131286621094,3950992,2698.5,3844154,0,106838
1642.6241459846497,3956782,2895.0,3849774,0,107008
1644.635247707367,3962835,3026.5,3855677,0,107158
1646.6463458538055,3967638,2401.5,3860340,0,107298
1648.6579160690308,3972507,2434.5,3865088,0,107419
1650.6740350723267,3978183,2838.0,3870630,0,107553
1652.6851994991302,3983224,2520.5,3875530,0,107694
1654.695970773697,3987113,1944.5,3879310,0,107803
1656.7111415863037,3991514,2200.5,3883595,0,107919
1658.7223591804504,3995968,2227.0,3887923,0,108045
1660.7343578338623,4000299,2165.5,3892157,0,108142
1662.7452561855316,4004763,2232.0,3896519,0,108244
1664.7594673633575,4009558,2397.5,3901210,0,108348
1666.7708401679993,4015020,2731.0,3906527,0,108493
1668.7822420597076,4020760,2870.0,3912108,0,108652
1670.7953295707703,4025596,2418.0,3916814,0,108782
1672.8078827857971,4030268,2336.0,3921343,0,108925
1674.8193039894104,4035924,2828.0,3926858,0,109066
1676.8301701545715,4041864,2970.0,3932652,0,109212
1678.8414392471313,4046763,2449.5,3937411,0,109352
1680.851923942566,4051696,2466.5,3942198,0,109498
1682.863044977188,4056891,2597.5,3947272,0,109619
1684.8742308616638,4061980,2544.5,3952219,0,109761
1686.877819776535,4066300,2160.0,3956430,0,109870
1688.8914778232574,4071272,2486.0,3961257,0,110015
1690.9025900363922,4076239,2483.5,3966096,0,110143
1692.91335105896,4081602,2681.5,3971311,0,110291
1694.9275114536285,4086496,2447.0,3976079,0,110417
1696.9360003471375,4090965,2234.5,3980437,0,110528
1698.946440935135,4095858,2446.5,3985192,0,110666
1700.9558682441711,4101628,2885.0,3990823,0,110805
1702.9585914611816,4107291,2831.5,3996318,0,110973
1704.9709117412567,4111562,2135.5,4000471,0,111091
1706.9833736419678,4117026,2732.0,4005789,0,111237
1708.9949572086334,4122092,2533.0,4010710,0,111382
1711.006886959076,4127950,2929.0,4016406,0,111544
1713.0175216197968,4132713,2381.5,4021034,0,111679
1715.033190727234,4137503,2395.0,4025689,0,111814
1717.044007062912,4141420,1958.5,4029495,0,111925
1719.0550656318665,4145602,2091.0,4033545,0,112057
1721.0662596225739,4150155,2276.5,4037971,0,112184
1723.0743072032928,4154930,2387.5,4042612,0,112318
1725.0868470668793,4159912,2491.0,4047464,0,112448
1727.0912034511566,4165013,2550.5,4052425,0,112588
1729.1016218662262,4170212,2599.5,4057486,0,112726
1731.1031923294067,4175240,2514.0,4062355,0,112885
1733.1138324737549,4181005,2882.5,4067988,0,113017
1735.125111579895,4186080,2537.5,4072913,0,113167
1737.1356809139252,4191076,2498.0,4077781,0,113295
1739.146150112152,4195896,2410.0,4082488,0,113408
1741.161961555481,4201442,2773.0,4087898,0,113544
1743.1636881828308,4206120,2339.0,4092460,0,113660
1745.174810886383,4210840,2360.0,4097068,0,113772
1747.190580368042,4215438,2299.0,4101558,0,113880
1749.1945962905884,4220659,2610.5,4106630,0,114029
1751.2072367668152,4225986,2663.5,4111809,0,114177
1753.220552444458,4230487,2250.5,4116188,0,114299
1755.2261989116669,4235198,2355.5,4120787,0,114411
1757.237428188324,4240427,2614.5,4125870,0,114557
1759.2488663196564,4244238,1905.5,4129586,0,114652
1761.259928703308,4248765,2263.5,4134011,0,114754
1763.2713961601257,4252630,1932.5,4137777,0,114853
1765.2825491428375,4258458,2914.0,4143448,0,115010
1767.3114154338837,4264292,2917.0,4149139,0,115153
1769.3233573436737,4268830,2269.0,4153577,0,115253
1771.3319623470306,4273553,2361.5,4158181,0,115372
1773.3424363136292,4278983,2715.0,4163471,0,115512
1775.3520822525024,4283560,2288.5,4167921,0,115639
1777.3556070327759,4288882,2661.0,4173117,0,115765
1779.3666644096375,4293899,2508.5,4178009,0,115890
1781.3773136138916,4298351,2226.0,4182329,0,116022
1783.388179063797,4302988,2318.5,4186829,0,116159
1785.3987438678741,4308726,2869.0,4192412,0,116314
1787.4093284606934,4313538,2406.0,4197121,0,116417
1789.4158935546875,4318697,2579.5,4202149,0,116548
1791.4280815124512,4324532,2917.5,4207848,0,116684
1793.4387423992157,4330034,2751.0,4213199,0,116835
1795.4491782188416,4335630,2798.0,4218654,0,116976
1797.4555056095123,4340360,2365.0,4223254,0,117106
1799.4691722393036,4345696,2668.0,4228444,0,117252
1801.4731268882751,4351043,2673.5,4233669,0,117374
1803.4814143180847,4356704,2830.5,4239186,0,117518
1805.494789838791,4361914,2605.0,4244253,0,117661
1807.4989252090454,4366871,2478.5,4249082,0,117789
1809.5096154212952,4372921,3025.0,4254971,0,117950
1811.5173013210297,4378163,2621.0,4260093,0,118070
1813.5336515903473,4383468,2652.5,4265254,0,118214
1815.5368974208832,4387794,2163.0,4269466,0,118328
1817.550577878952,4391231,1718.5,4272829,0,118402
1819.5665137767792,4396431,2600.0,4277892,0,118539
1821.5800178050995,4401776,2672.5,4283102,0,118674
1823.585776090622,4406725,2474.5,4287908,0,118817
1825.5975766181946,4412119,2697.0,4293186,0,118933
1827.6089451313019,4417398,2639.5,4298317,0,119081
1829.618644475937,4420340,1471.0,4301183,0,119157
1831.6274116039276,4424647,2153.5,4305381,0,119266
1833.6406409740448,4430134,2743.5,4310724,0,119410
1835.6516201496124,4434780,2323.0,4315256,0,119524
1837.6594932079315,4439771,2495.5,4320097,0,119674
1839.6638269424438,4445035,2632.0,4325245,0,119790
1841.6745746135712,4450239,2602.0,4330318,0,119921
1843.6897330284119,4454861,2311.0,4334833,0,120028
1845.6997606754303,4459417,2278.0,4339280,0,120137
1847.7112731933594,4465028,2805.5,4344727,0,120301
1849.7215189933777,4470959,2965.5,4350484,0,120475
1851.727329492569,4475110,2075.5,4354530,0,120580
1853.7326354980469,4480406,2648.0,4359696,0,120710
1855.7453899383545,4486439,3016.5,4365560,0,120879
1857.7464871406555,4491478,2519.5,4370459,0,121019
1859.7559955120087,4496219,2370.5,4375075,0,121144
1861.7707023620605,4501653,2717.0,4380369,0,121284
1863.7724595069885,4507157,2752.0,4385751,0,121406
1865.7788195610046,4511398,2120.5,4389872,0,121526
1867.7831704616547,4516549,2575.5,4394893,0,121656
1869.7963347434998,4521924,2687.5,4400126,0,121798
1871.8109135627747,4526518,2297.0,4404614,0,121904
1873.8229863643646,4531634,2558.0,4409607,0,122027
1875.8342607021332,4535283,1824.5,4413172,0,122111
1877.8452320098877,4540536,2626.5,4418277,0,122259
1879.8592510223389,4543691,1577.5,4421358,0,122333
1881.8745391368866,4547350,1829.5,4424933,0,122417
1883.8896837234497,4551681,2165.5,4429156,0,122525
1885.8954939842224,4556632,2475.5,4433970,0,122662
1887.9026114940643,4561725,2546.5,4438925,0,122800
1889.9121646881104,4566634,2454.5,4443719,0,122915
1891.922857761383,4571980,2673.0,4448938,0,123042
1893.9295876026154,4576953,2486.5,4453770,0,123183
1895.938483953476,4581754,2400.5,4458455,0,123299
1897.9415168762207,4586880,2563.0,4463445,0,123435
1899.95619058609,4591287,2203.5,4467721,0,123566
1901.9618966579437,4595376,2044.5,4471706,0,123670
1903.9736535549164,4599229,1926.5,4475439,0,123790
1905.981323003769,4603981,2376.0,4480050,0,123931
1907.9968259334564,4607668,1843.5,4483645,0,124023
1910.0118408203125,4611797,2064.5,4487662,0,124135
1912.020833492279,4616973,2588.0,4492684,0,124289
1914.0242261886597,4621969,2498.0,4497552,0,124417
1916.0393152236938,4626756,2393.5,4502210,0,124546
1918.054206609726,4632425,2834.5,4507722,0,124703
1920.0554378032684,4637724,2649.5,4512897,0,124827
1922.0566170215607,4642430,2353.0,4517472,0,124958
1924.0693044662476,4647523,2546.5,4522446,0,125077
1926.0739884376526,4652404,2440.5,4527200,0,125204
1928.0874745845795,4656870,2233.0,4531560,0,125310
1930.0945556163788,4661990,2560.0,4536538,0,125452
1932.1023483276367,4667199,2604.5,4541603,0,125596
1934.1148836612701,4672875,2838.0,4547137,0,125738
1936.1209728717804,4676768,1946.5,4550929,0,125839
1938.1253674030304,4681484,2358.0,4555526,0,125958
1940.126475572586,4686343,2429.5,4560241,0,126102
1942.1362886428833,4691531,2594.0,4565278,0,126253
1944.1392471790314,4696226,2347.5,4569819,0,126407
1946.146755695343,4701658,2716.0,4575097,0,126561
1948.1487197875977,4706720,2531.0,4580004,0,126716
1950.1562130451202,4710603,1941.5,4583790,0,126813
1952.1647787094116,4715505,2451.0,4588557,0,126948
1954.172533750534,4720817,2656.0,4593720,0,127097
1956.18101978302,4725646,2414.5,4598420,0,127226
1958.188142299652,4730501,2427.5,4603138,0,127363
1960.1984746456146,4735997,2748.0,4608489,0,127508
1962.2125356197357,4740667,2335.0,4613026,0,127641
1964.217594385147,4744487,1910.0,4616745,0,127742
1966.2175958156586,4748584,2048.5,4620726,0,127858
1968.2328507900238,4753227,2321.5,4625234,0,127993
1970.2441828250885,4758329,2551.0,4630210,0,128119
1972.259649515152,4762970,2320.5,4634740,0,128230
1974.2662951946259,4767821,2425.5,4639460,0,128361
1976.278814792633,4773007,2593.0,4644502,0,128505
1978.2826569080353,4778225,2609.0,4649584,0,128641
1980.297285079956,4783189,2482.0,4654433,0,128756
1982.3047277927399,4787767,2289.0,4658876,0,128891
1984.3187527656555,4792487,2360.0,4663475,0,129012
1986.3196465969086,4797805,2659.0,4668656,0,129149
1988.32093334198,4800601,1398.0,4671378,0,129223
1990.3266816139221,4805683,2541.0,4676325,0,129358
1992.329027891159,4811576,2946.5,4682062,0,129514
1994.3336732387543,4815214,1819.0,4685604,0,129610
1996.3391890525818,4820394,2590.0,4690658,0,129736
1998.3488466739655,4825187,2396.5,4695329,0,129858
2000.3564016819,4830840,2826.5,4700829,0,130011
2002.3689720630646,4835694,2427.0,4705557,0,130137
2004.3789322376251,4840064,2185.0,4709812,0,130252
2006.383089542389,4845151,2543.5,4714778,0,130373
2008.3855407238007,4849674,2261.5,4719145,0,130529
2010.3871626853943,4854521,2423.5,4723868,0,130653
2012.3897030353546,4859772,2625.5,4728984,0,130788
2014.3901512622833,4864860,2544.0,4733945,0,130915
2016.393750667572,4869243,2191.5,4738211,0,131032
2018.402672290802,4874235,2496.0,4743098,0,131137
2020.4080212116241,4879677,2721.0,4748402,0,131275
2022.419374704361,4885009,2666.0,4753605,0,131404
2024.4298696517944,4890063,2527.0,4758515,0,131548
2026.4298975467682,4894664,2300.5,4762978,0,131686
2028.4415984153748,4899328,2332.0,4767506,0,131822
2030.443193435669,4904743,2707.5,4772773,0,131970
2032.4459233283997,4909641,2449.0,4777529,0,132112
2034.4533977508545,4914514,2436.5,4782273,0,132241
2036.4659311771393,4919593,2539.5,4787219,0,132374
2038.4660902023315,4924094,2250.5,4791585,0,132509
2040.466475725174,4928924,2415.0,4796303,0,132621
2042.4789826869965,4933613,2344.5,4800867,0,132746
2044.4945766925812,4938297,2342.0,4805439,0,132858
2046.497584104538,4944092,2897.5,4811079,0,133013
2048.5022745132446,4948979,2443.5,4815832,0,133147
2050.5087356567383,4953850,2435.5,4820577,0,133273
2052.5226628780365,4958980,2565.0,4825566,0,133414
2054.5355262756348,4964697,2858.5,4831118,0,133579
2056.5420246124268,4970220,2761.5,4836472,0,133748
2058.5426774024963,4975377,2578.5,4841503,0,133874
2060.5572707653046,4980117,2370.0,4846128,0,133989
2062.572031736374,4985474,2678.5,4851347,0,134127
2064.5732979774475,4990289,2407.5,4856040,0,134249
2066.5831055641174,4994742,2226.5,4860392,0,134350
2068.5909810066223,4999937,2597.5,4865455,0,134482
2070.593521118164,5005570,2816.5,4870919,0,134651
2072.5975387096405,5010918,2674.0,4876124,0,134794
2074.60657954216,5014736,1909.0,4879838,0,134898
2076.613377571106,5019890,2577.0,4884821,0,135069
2078.62411737442,5025490,2800.0,4890253,0,135237
2080.6397137641907,5030970,2740.0,4895595,0,135375
2082.640416622162,5035519,2274.5,4900026,0,135493
2084.65628862381,5040440,2460.5,4904825,0,135615
2086.6582655906677,5045709,2634.5,4909954,0,135755
2088.660195350647,5051016,2653.5,4915106,0,135910
2090.6619052886963,5056039,2511.5,4919990,0,136049
2092.6783611774445,5061344,2652.5,4925152,0,136192
2094.6898789405823,5067052,2854.0,4930710,0,136342
2096.703033685684,5072868,2908.0,4936382,0,136486
2098.715703725815,5077685,2408.5,4941072,0,136613
2100.7224848270416,5082450,2382.5,4945695,0,136755
2102.7353007793427,5087985,2767.5,4951067,0,136918
2104.7404289245605,5092845,2430.0,4955804,0,137041
2106.756897687912,5098032,2593.5,4960869,0,137163
2108.772852897644,5102689,2328.5,4965400,0,137289
2110.7753558158875,5107558,2434.5,4970152,0,137406
2112.791607618332,5113129,2785.5,4975569,0,137560
2114.805109500885,5117347,2109.0,4979665,0,137682
2116.8157365322113,5122969,2811.0,4985118,0,137851
2118.8280255794525,5128686,2858.5,4990687,0,137999
2120.8325448036194,5133052,2183.0,4994943,0,138109
2122.837294101715,5137429,2188.5,4999208,0,138221
2124.8457193374634,5142850,2710.5,5004478,0,138372
2126.861268758774,5148590,2870.0,5010066,0,138524
2128.876579284668,5153590,2500.0,5014927,0,138663
2130.8899269104004,5159175,2792.5,5020374,0,138801
2132.900836467743,5164402,2613.5,5025448,0,138954
2134.9060072898865,5168412,2005.0,5029354,0,139058
2136.9089965820312,5172799,2193.5,5033631,0,139168
2138.910420894623,5178117,2659.0,5038818,0,139299
2140.915251016617,5183129,2506.0,5043693,0,139436
2142.9299042224884,5188197,2534.0,5048643,0,139554
2144.944867372513,5192632,2217.5,5052957,0,139675
2146.955821990967,5198046,2707.0,5058206,0,139840
2148.9696815013885,5203383,2668.5,5063379,0,140004
2150.974198579788,5208684,2650.5,5068536,0,140148
2152.980801343918,5213190,2253.0,5072946,0,140244
2154.9876205921173,5218852,2831.0,5078472,0,140380
2156.9904232025146,5223175,2161.5,5082692,0,140483
2158.9966876506805,5227143,1984.0,5086561,0,140582
2161.0095591545105,5232063,2460.0,5091343,0,140720
2163.023435354233,5236708,2322.5,5095871,0,140837
2165.0344421863556,5242556,2924.0,5101572,0,140984
2167.0468356609344,5247390,2417.0,5106289,0,141101
2169.0593395233154,5252204,2407.0,5110988,0,141216
2171.064400434494,5257733,2764.5,5116374,0,141359
2173.0765120983124,5262725,2496.0,5121246,0,141479
2175.083103656769,5267433,2354.0,5125818,0,141615
2177.0980665683746,5272950,2758.5,5131209,0,141741
2179.11243891716,5277267,2158.5,5135432,0,141835
2181.127281188965,5282331,2532.0,5140327,0,142004
2183.1397519111633,5287354,2511.5,5145233,0,142121
2185.153720140457,5293172,2909.0,5150884,0,142288
2187.163177251816,5298420,2624.0,5156003,0,142417
2189.17368888855,5303861,2720.5,5161313,0,142548
2191.1847381591797,5308827,2483.0,5166153,0,142674
2193.1897790431976,5313875,2524.0,5171073,0,142802
2195.203831911087,5318896,2510.5,5175962,0,142934
2197.220041036606,5324190,2647.0,5181115,0,143075
2199.2315690517426,5328824,2317.0,5185628,0,143196
2201.2335324287415,5333405,2290.5,5190083,0,143322
2203.2452278137207,5338448,2521.5,5195011,0,143437
2205.261246919632,5343757,2654.5,5200203,0,143554
2207.26491689682,5347987,2115.0,5204309,0,143678
2209.276155948639,5353187,2600.0,5209368,0,143819
2211.284362077713,5358561,2687.0,5214618,0,143943
2213.2965035438538,5363947,2693.0,5219847,0,144100
2215.3081698417664,5368629,2341.0,5224394,0,144235
2217.3166308403015,5373343,2357.0,5228973,0,144370
2219.327201128006,5378420,2538.5,5233928,0,144492
2221.33229136467,5382066,1823.0,5237476,0,144590
2223.332934617996,5386403,2168.5,5241700,0,144703
2225.3373441696167,5391157,2377.0,5246331,0,144826
2227.338882923126,5396174,2508.5,5251200,0,144974
2229.354122400284,5400802,2314.0,5255713,0,145089
2231.3683018684387,5405660,2429.0,5260431,0,145229
2233.3744838237762,5411089,2714.5,5265717,0,145372
2235.385825395584,5416200,2555.5,5270696,0,145504
2237.3965673446655,5420951,2375.5,5275328,0,145623
2239.4091472625732,5426410,2729.5,5280642,0,145768
2241.411821603775,5431667,2628.5,5285775,0,145892
2243.425964832306,5436461,2397.0,5290429,0,146032
2245.4266200065613,5441029,2284.0,5294878,0,146151
2247.4356274604797,5445885,2428.0,5299609,0,146276
2249.4475944042206,5450898,2506.5,5304492,0,146406
2251.4515209198,5456119,2610.5,5309569,0,146550
2253.4620106220245,5461857,2869.0,5315168,0,146689
2255.4774346351624,5465318,1730.5,5318527,0,146791
2257.480404615402,5470616,2649.0,5323682,0,146934
2259.4861199855804,5475801,2592.5,5328738,0,147063
2261.5000472068787,5480334,2266.5,5333166,0,147168
2263.5067229270935,5484416,2041.0,5337130,0,147286
2265.5176231861115,5489904,2744.0,5342473,0,147431
2267.524001121521,5495481,2788.5,5347915,0,147566
2269.5270528793335,5500618,2568.5,5352939,0,147679
2271.5405995845795,5505766,2574.0,5357958,0,147808
2273.547454357147,5510566,2400.0,5362624,0,147942
2275.558422803879,5516644,3039.0,5368557,0,148087
2277.56902885437,5522282,2819.0,5374042,0,148240
2279.5791108608246,5526762,2240.0,5378405,0,148357
2281.5803270339966,5531221,2229.5,5382745,0,148476
2283.581260204315,5536729,2754.0,5388094,0,148635
2285.5927946567535,5541753,2512.0,5392989,0,148764
2287.607507944107,5546975,2611.0,5398047,0,148928
2289.618531703949,5551679,2352.0,5402640,0,149039
2291.631374359131,5557571,2946.0,5408348,0,149223
2293.6419701576233,5563286,2857.5,5413905,0,149381
2295.6484632492065,5569118,2916.0,5419577,0,149541
2297.664340019226,5574104,2493.0,5424438,0,149666
2299.6747999191284,5579492,2694.0,5429691,0,149801
2301.6910161972046,5585149,2828.5,5435196,0,149953
2303.6954021453857,5590776,2813.5,5440673,0,150103
2305.6997661590576,5595771,2497.5,5445550,0,150221
2307.711547613144,5601265,2747.0,5450927,0,150338
2309.7248668670654,5606893,2814.0,5456407,0,150486
2311.7277884483337,5612253,2680.0,5461640,0,150613
2313.7383143901825,5616795,2271.0,5466068,0,150727
2315.743909597397,5621674,2439.5,5470802,0,150872
2317.7505412101746,5627103,2714.5,5476093,0,151010
2319.7637042999268,5632418,2657.5,5481283,0,151135
2321.7681245803833,5636624,2103.0,5485401,0,151223
2323.779693841934,5641646,2511.0,5490297,0,151349
2325.7931015491486,5646968,2661.0,5495476,0,151492
2327.804799079895,5652207,2619.5,5500567,0,151640
2329.8093752861023,5657141,2467.0,5505359,0,151782
2331.8247759342194,5662579,2719.0,5510663,0,151916
2333.8306453227997,5667459,2440.0,5515410,0,152049
2335.8427090644836,5673213,2877.0,5520986,0,152227
2337.8456127643585,5678023,2405.0,5525674,0,152349
2339.859760761261,5683126,2551.5,5530624,0,152502
2341.8740549087524,5689044,2959.0,5536379,0,152665
2343.8760216236115,5694696,2826.0,5541869,0,152827
2345.8862960338593,5699428,2366.0,5546497,0,152931
2347.8986978530884,5705168,2870.0,5552095,0,153073
2349.9027388095856,5710507,2669.5,5557293,0,153214
2351.9141738414764,5716005,2749.0,5562655,0,153350
2353.920872449875,5720697,2346.0,5567227,0,153470
2355.9363849163055,5725604,2453.5,5572018,0,153586
2357.944058895111,5731210,2803.0,5577501,0,153709
2359.9584336280823,5736130,2460.0,5582289,0,153841
2361.9742560386658,5740988,2429.0,5587028,0,153960
2363.9786233901978,5745815,2413.5,5591727,0,154088
2365.992109298706,5751783,2984.0,5597542,0,154241
2367.9969942569733,5756681,2449.0,5602307,0,154374
2370.0089247226715,5761776,2547.5,5607256,0,154520
2372.0204157829285,5766575,2399.5,5611930,0,154645
2374.0330772399902,5771128,2276.5,5616361,0,154767
2376.035710334778,5775193,2032.5,5620316,0,154877
2378.0492038726807,5779538,2172.5,5624543,0,154995
2380.053822040558,5784765,2613.5,5629631,0,155134
2382.0673308372498,5789944,2589.5,5634675,0,155269
2384.077307701111,5794751,2403.5,5639375,0,155376
2386.0851612091064,5799646,2447.5,5644136,0,155510
2388.0949079990387,5805254,2804.0,5649581,0,155673
2390.0985236167908,5810400,2573.0,5654590,0,155810
2392.1066358089447,5815346,2473.0,5659397,0,155949
2394.1128022670746,5819881,2267.5,5663807,0,156074
2396.122702598572,5824897,2508.0,5668696,0,156201
2398.123192548752,5829999,2551.0,5673662,0,156337
2400.1255357265472,5834676,2338.5,5678212,0,156464
2402.1295862197876,5839901,2612.5,5683285,0,156616
2404.141310453415,5845568,2833.5,5688809,0,156759
2406.141756296158,5851146,2789.0,5694227,0,156919
2408.1570694446564,5856202,2528.0,5699137,0,157065
2410.1648144721985,5860934,2366.0,5703757,0,157177
2412.1756553649902,5865960,2513.0,5708646,0,157314
2414.179500579834,5871771,2905.5,5714310,0,157461
2416.194398880005,5876532,2380.5,5718931,0,157601
2418.203023672104,5881060,2264.0,5723347,0,157713
2420.2133066654205,5886023,2481.5,5728192,0,157831
2422.2227993011475,5891942,2959.5,5733952,0,157990
2424.2239577770233,5896422,2240.0,5738321,0,158101
2426.228593111038,5901308,2443.0,5743107,0,158201
2428.2326531410217,5906947,2819.5,5748598,0,158349
2430.2376968860626,5912707,2880.0,5754208,0,158499
2432.237909555435,5918215,2754.0,5759558,0,158657
2434.239542245865,5922694,2239.5,5763939,0,158755
2436.2544996738434,5927559,2432.5,5768668,0,158891
2438.2557685375214,5932560,2500.5,5773544,0,159016
2440.262779712677,5937723,2581.5,5778581,0,159142
2442.273252248764,5942280,2278.5,5783023,0,159257
2444.276083469391,5947700,2710.0,5788300,0,159400
2446.2906279563904,5953021,2660.5,5793479,0,159542
2448.3004128932953,5958585,2782.0,5798899,0,159686
2450.303897857666,5963660,2537.5,5803853,0,159807
2452.315491437912,5968446,2393.0,5808519,0,159927
2454.3184292316437,5974046,2800.0,5813990,0,160056
2456.3321759700775,5979575,2764.5,5819379,0,160196
2458.345379114151,5983835,2130.0,5823548,0,160287
2460.351977825165,5989228,2696.5,5828795,0,160433
2462.3627467155457,5994701,2736.5,5834121,0,160580
2464.373745203018,6000391,2845.0,5839656,0,160735
2466.3785173892975,6005268,2438.5,5844402,0,160866
2468.386939764023,6010237,2484.5,5849258,0,160979
2470.387508869171,6015374,2568.5,5854264,0,161110
2472.3894398212433,6020074,2350.0,5858846,0,161228
2474.3969798088074,6024954,2440.0,5863577,0,161377
2476.4082276821136,6030314,2680.0,5868787,0,161527
2478.41526389122,6035082,2384.0,5873449,0,161633
2480.4249262809753,6040538,2728.0,5878783,0,161755
2482.4368195533752,6043554,1508.0,5881736,0,161818
2484.4436910152435,6047592,2019.0,5885672,0,161920
2486.450591802597,6052547,2477.5,5890467,0,162080
2488.4583275318146,6058147,2800.0,5895927,0,162220
2490.472021818161,6063845,2849.0,5901462,0,162383
2492.472139596939,6068567,2361.0,5906080,0,162487
2494.478746652603,6073322,2377.5,5910695,0,162627
2496.4921882152557,6078120,2399.0,5915366,0,162754
2498.502609729767,6083225,2552.5,5920320,0,162905
2500.504311323166,6087700,2237.5,5924696,0,163004
2502.5132732391357,6092858,2579.0,5929723,0,163135
2504.525339126587,6097752,2447.0,5934477,0,163275
2506.5393776893616,6102526,2387.0,5939126,0,163400
2508.5531735420227,6107037,2255.5,5943500,0,163537
2510.5544044971466,6111888,2425.5,5948215,0,163673
2512.5589990615845,6117040,2576.0,5953233,0,163807
2514.579991340637,6122456,2708.0,5958514,0,163942
2516.5925302505493,6127583,2563.5,5963514,0,164069
2518.604536294937,6132830,2623.5,5968627,0,164203
2520.6171250343323,6137826,2498.0,5973490,0,164336
2522.6220281124115,6141611,1892.5,5977170,0,164441
2524.6374049186707,6146553,2471.0,5981983,0,164570
2526.650530099869,6151446,2446.5,5986742,0,164704
2528.6505703926086,6156360,2457.0,5991522,0,164838
2530.6560525894165,6161165,2402.5,5996198,0,164967
2532.661645412445,6166006,2420.5,6000898,0,165108
2534.6658391952515,6171308,2651.0,6006056,0,165252
2536.6765863895416,6176932,2812.0,6011529,0,165403
2538.6885821819305,6181915,2491.5,6016384,0,165531
2540.694036960602,6186906,2495.5,6021230,0,165676
2542.6984865665436,6192393,2743.5,6026577,0,165816
2544.7095963954926,6197675,2641.0,6031720,0,165955
2546.7193603515625,6202622,2473.5,6036538,0,166084
2548.7264783382416,6207935,2656.5,6041716,0,166219
2550.7270011901855,6213181,2623.0,6046830,0,166351
2552.7293643951416,6218569,2694.0,6052094,0,166475
2554.7337634563446,6222872,2151.5,6056271,0,166601
2556.7444541454315,6227854,2491.0,6061132,0,166722
2558.749910593033,6232957,2551.5,6066086,0,166871
2560.7740728855133,6237992,2517.5,6070975,0,167017
2562.7770907878876,6243038,2523.0,6075888,0,167150
2564.7843627929688,6248427,2694.5,6081127,0,167300
2566.7899742126465,6253870,2721.5,6086421,0,167449
2568.818576812744,6259191,2660.5,6091602,0,167589
2570.8270919322968,6265257,3033.0,6097515,0,167742
2572.8420853614807,6270679,2711.0,6102795,0,167884
2574.8447964191437,6276289,2805.0,6108243,0,168046
2576.8523082733154,6281340,2525.5,6113163,0,168177
2578.859407901764,6286138,2399.0,6117827,0,168311
2580.8603920936584,6291565,2713.5,6123111,0,168454
2582.8631250858307,6297371,2903.0,6128784,0,168587
2584.8788702487946,6302118,2373.5,6133404,0,168714
2586.894653558731,6307346,2614.0,6138494,0,168852
2588.909547805786,6312947,2800.5,6143970,0,168977
2590.9096505641937,6318347,2700.0,6149240,0,169107
2592.9144282341003,6323706,2679.5,6154465,0,169241
2594.9245851039886,6329333,2813.5,6159929,0,169404
2596.940422773361,6335459,3063.0,6165900,0,169559
2598.952724456787,6341230,2885.5,6171525,0,169705
2600.9586350917816,6345601,2185.5,6175783,0,169818
2602.9638180732727,6351244,2821.5,6181275,0,169969
2604.9744679927826,6356527,2641.5,6186428,0,170099
2606.9904856681824,6361354,2413.5,6191124,0,170230
2609.006355524063,6365945,2295.5,6195594,0,170351
2611.017499923706,6371277,2666.0,6200801,0,170476
2613.0314247608185,6377032,2877.5,6206415,0,170617
2615.0460152626038,6380607,1787.5,6209905,0,170702
2617.050708770752,6385421,2407.0,6214590,0,170831
2619.063243150711,6389840,2209.5,6218893,0,170947
2621.073869228363,6394891,2525.5,6223801,0,171090
2623.084947824478,6400386,2747.5,6229151,0,171235
2625.096611022949,6405820,2717.0,6234449,0,171371
2627.1090722084045,6411197,2688.5,6239667,0,171530
2629.120025396347,6416056,2429.5,6244388,0,171668
2631.1333780288696,6421438,2691.0,6249642,0,171796
2633.139605998993,6426716,2639.0,6254783,0,171933
2635.14390540123,6432501,2892.5,6260395,0,172106
2637.15150141716,6436834,2166.5,6264615,0,172219
2639.1534128189087,6441554,2360.0,6269203,0,172351
2641.160334587097,6447373,2909.5,6274859,0,172514
2643.1624145507812,6453081,2854.0,6280417,0,172664
2645.163268327713,6458789,2854.0,6285992,0,172797
2647.1649413108826,6463765,2488.0,6290827,0,172938
2649.1659948825836,6468980,2607.5,6295907,0,173073
2651.1682271957397,6474679,2849.5,6301442,0,173237
2653.179362297058,6479162,2241.5,6305803,0,173359
2655.1844363212585,6484224,2531.0,6310717,0,173507
2657.185870409012,6489848,2812.0,6316199,0,173649
2659.196930885315,6494356,2254.0,6320597,0,173759
2661.211799621582,6499913,2778.5,6325993,0,173920
2663.2229924201965,6504292,2189.5,6330271,0,174021
2665.233699321747,6509214,2461.0,6335071,0,174143
2667.241592645645,6515029,2907.5,6340734,0,174295
2669.253997325897,6520298,2634.5,6345850,0,174448
2671.2643835544586,6525317,2509.5,6350724,0,174593
2673.276750564575,6530367,2525.0,6355679,0,174688
2675.285860300064,6535341,2487.0,6360505,0,174836
2677.3052365779877,6540867,2763.0,6365872,0,174995
2679.3137278556824,6545242,2187.5,6370119,0,175123
2681.326718568802,6550094,2426.0,6374835,0,175259
2683.3373699188232,6554952,2429.0,6379548,0,175404
2685.3450038433075,6559622,2335.0,6384101,0,175521
2687.3578152656555,6562336,1357.0,6386742,0,175594
2689.364476919174,6567113,2388.5,6391413,0,175700
2691.3730947971344,6571920,2403.5,6396111,0,175809
2693.3778080940247,6576494,2287.0,6400563,0,175931
2695.3884897232056,6581933,2719.5,6405853,0,176080
2697.3960218429565,6586526,2296.5,6410305,0,176221
2699.4057738780975,6590912,2193.0,6414563,0,176349
2701.4076714515686,6594934,2011.0,6418491,0,176443
2703.4164369106293,6599389,2227.5,6422824,0,176565
2705.428359746933,6604310,2460.5,6427617,0,176693
2707.43847489357,6609570,2630.0,6432728,0,176842
2709.4432644844055,6614608,2519.0,6437646,0,176962
2711.4560861587524,6618461,1926.5,6441392,0,177069
2713.471225500107,6622656,2097.5,6445466,0,177190
2715.474114179611,6627937,2640.5,6450608,0,177329
2717.486288547516,6632862,2462.5,6455414,0,177448
2719.4972338676453,6637825,2481.5,6460228,0,177597
2721.5124113559723,6643023,2599.0,6465284,0,177739
2723.527128458023,6647757,2367.0,6469889,0,177868
2725.5380580425262,6652380,2311.5,6474388,0,177992
2727.5515615940094,6656544,2082.0,6478442,0,178102
2729.5584754943848,6661183,2319.5,6482967,0,178216
2731.567215204239,6666495,2656.0,6488147,0,178348
3748.224960565567,6671878,2691.5,6493400,0,178478
3750.228886604309,6673286,704.0,6494772,0,178514
3752.244218826294,6674923,818.5,6496371,0,178552
3754.2473769187927,6678436,1756.5,6499803,0,178633
3756.259006023407,6682086,1825.0,6503365,0,178721
3758.2647399902344,6684776,1345.0,6505979,0,178797
3760.2702901363373,6688828,2026.0,6509924,0,178904
3762.2727818489075,6693696,2434.0,6514651,0,179045
3764.2764990329742,6698942,2623.0,6519758,0,179184
3766.2776103019714,6703732,2395.0,6524426,0,179306
3768.2857325077057,6707865,2066.5,6528456,0,179409
3770.2974042892456,6713236,2685.5,6533678,0,179558
3772.30926656723,6718892,2828.0,6539178,0,179714
3774.326832294464,6723578,2343.0,6543750,0,179828
3776.3324661254883,6728483,2452.5,6548549,0,179934
3778.333158969879,6733010,2263.5,6552968,0,180042
3780.3356609344482,6737970,2480.0,6557792,0,180178
3782.342573404312,6742611,2320.5,6562327,0,180284
3784.3515372276306,6747297,2343.0,6566882,0,180415
3786.3611776828766,6752205,2454.0,6571690,0,180515
3788.3614757061005,6757938,2866.5,6577283,0,180655
3790.3735818862915,6762922,2492.0,6582139,0,180783
3792.3882756233215,6768110,2594.0,6587189,0,180921
3794.389467716217,6773662,2776.0,6592598,0,181064
3796.3946442604065,6779011,2674.5,6597810,0,181201
3798.40180516243,6783761,2375.0,6602440,0,181321
3800.406218290329,6788658,2448.5,6607210,0,181448
3802.406239748001,6794144,2743.0,6612573,0,181571
3804.418139696121,6797903,1879.5,6616261,0,181642
3806.4245727062225,6800838,1467.5,6619126,0,181712
3808.433609724045,6805461,2311.5,6623616,0,181845
3810.438021659851,6811260,2899.5,6629273,0,181987
3812.440839767456,6816577,2658.5,6634440,0,182137
3814.4518105983734,6821524,2473.5,6639249,0,182275
3816.4527645111084,6826888,2682.0,6644469,0,182419
3818.456146478653,6832444,2778.0,6649893,0,182551
3820.457643032074,6837975,2765.5,6655281,0,182694
3822.4631202220917,6843017,2521.0,6660188,0,182829
3824.475956439972,6847679,2331.0,6664718,0,182961
3826.4811210632324,6852482,2401.5,6669423,0,183059
3828.4879055023193,6858330,2924.0,6675126,0,183204
3830.497908115387,6863955,2812.5,6680598,0,183357
3832.502683877945,6868982,2513.5,6685514,0,183468
3834.516741991043,6874297,2657.5,6690684,0,183613
3836.521662712097,6879280,2491.5,6695542,0,183738
3838.529988050461,6883566,2143.0,6699724,0,183842
3840.5320162773132,6888606,2520.0,6704632,0,183974
3842.5366973876953,6892415,1904.5,6708352,0,184063
3844.536774158478,6897539,2562.0,6713341,0,184198
3846.5443902015686,6903306,2883.5,6718953,0,184353
3848.5554342269897,6908054,2374.0,6723562,0,184492
3850.5565044879913,6911883,1914.5,6727308,0,184575
3852.563292980194,6915188,1652.5,6730514,0,184674
3854.578329563141,6919376,2094.0,6734602,0,184774
3856.5819470882416,6924262,2443.0,6739359,0,184903
3858.587776660919,6929934,2836.0,6744901,0,185033
3860.598546743393,6935150,2608.0,6749971,0,185179
3862.6118347644806,6940295,2572.5,6754990,0,185305
3864.616182088852,6945263,2484.0,6759822,0,185441
3866.627739906311,6950950,2843.5,6765342,0,185608
3868.6433713436127,6956850,2950.0,6771094,0,185756
3870.643534898758,6962341,2745.5,6776425,0,185916
3872.6478395462036,6966804,2231.5,6780763,0,186041
3874.6621618270874,6972092,2644.0,6785928,0,186164
3876.663382291794,6977931,2919.5,6791611,0,186320
3878.674200296402,6983857,2963.0,6797370,0,186487
3880.6820471286774,6988257,2200.0,6801655,0,186602
3882.6908547878265,6991445,1594.0,6804761,0,186684
3884.703574180603,6994344,1449.5,6807588,0,186756
3886.7161314487457,6999596,2626.0,6812695,0,186901
3888.7282552719116,7005061,2732.5,6818013,0,187048
3890.741267681122,7010142,2540.5,6822971,0,187171
3892.7511932849884,7015738,2798.0,6828451,0,187287
3894.7631809711456,7020787,2524.5,6833368,0,187419
3896.7685306072235,7025917,2565.0,6838369,0,187548
3898.776619911194,7030903,2493.0,6843213,0,187690
3900.7800426483154,7036047,2572.0,6848226,0,187821
3902.789975166321,7041519,2736.0,6853569,0,187950
3904.7918157577515,7046550,2515.5,6858458,0,188092
3906.795242547989,7051300,2375.0,6863085,0,188215
3908.801500558853,7056869,2784.5,6868492,0,188377
3910.8169367313385,7062735,2933.0,6874211,0,188524
3912.8172523975372,7068029,2647.0,6879352,0,188677
3914.829190969467,7073467,2719.0,6884638,0,188829
3916.844904899597,7077624,2078.5,6888688,0,188936
3918.845323562622,7083231,2803.5,6894144,0,189087
3920.8590161800385,7088824,2796.5,6899607,0,189217
3922.860463619232,7093620,2398.0,6904278,0,189342
3924.8737604618073,7098374,2377.0,6908892,0,189482
3926.874064207077,7104219,2922.5,6914588,0,189631
3928.876343011856,7109378,2579.5,6919610,0,189768
3930.888434410095,7114348,2485.0,6924455,0,189893
3932.899731874466,7119133,2392.5,6929128,0,190005
3934.9045510292053,7124120,2493.5,6933975,0,190145
3936.9045717716217,7129801,2840.5,6939512,0,190289
3938.9094734191895,7134960,2579.5,6944550,0,190410
3940.9108140468597,7140191,2615.5,6949648,0,190543
3942.9224858283997,7145867,2838.0,6955162,0,190705
3944.9229271411896,7151197,2665.0,6960347,0,190850
3946.9230670928955,7156681,2742.0,6965687,0,190994
3948.9297482967377,7161073,2196.0,6969960,0,191113
3950.94527053833,7166013,2470.0,6974770,0,191243
3952.94527053833,7171912,2949.5,6980526,0,191386
3954.946963071823,7177339,2713.5,6985802,0,191537
3956.962255001068,7181612,2136.5,6989942,0,191670
3958.9720389842987,7186613,2500.5,6994805,0,191808
3960.976176261902,7191573,2480.0,6999636,0,191937
3962.9864025115967,7196268,2347.5,7004189,0,192079
3964.9956951141357,7201125,2428.5,7008924,0,192201
3967.0048468112946,7206959,2917.0,7014618,0,192341
3969.004926919937,7211939,2490.0,7019476,0,192463
3971.0098071098328,7216565,2313.0,7023991,0,192574
3973.02548456192,7222014,2724.5,7029318,0,192696
3975.0409684181213,7227146,2566.0,7034312,0,192834
3977.042070388794,7231616,2235.0,7038662,0,192954
3979.0548419952393,7236237,2310.5,7043163,0,193074
3981.068098783493,7240994,2378.5,7047782,0,193212
3983.072685480118,7246616,2811.0,7053269,0,193347
3985.073982477188,7251410,2397.0,7057942,0,193468
3987.084942340851,7255562,2076.0,7061985,0,193577
3989.0984733104706,7260619,2528.5,7066883,0,193736
3991.113054037094,7265804,2592.5,7071936,0,193868
3993.125532388687,7269668,1932.0,7075715,0,193953
3995.1411736011505,7274288,2310.0,7080195,0,194093
3997.1416399478912,7279845,2778.5,7085607,0,194238
3999.142405986786,7284409,2282.0,7090067,0,194342
4001.1511449813843,7289117,2354.0,7094635,0,194482
4003.158353328705,7294188,2535.5,7099564,0,194624
4005.1685194969177,7298910,2361.0,7104161,0,194749
4007.1800651550293,7303639,2364.5,7108764,0,194875
4009.1939432621,7308137,2249.0,7113127,0,195010
4011.194528579712,7313131,2497.0,7117970,0,195161
4013.1946811676025,7318125,2497.0,7122820,0,195305
4015.1979520320892,7322770,2322.5,7127363,0,195407
4017.198404073715,7327425,2327.5,7131897,0,195528
4019.2090599536896,7332719,2647.0,7137070,0,195649
4021.2143330574036,7338085,2683.0,7142286,0,195799
4023.214453935623,7343432,2673.5,7147491,0,195941
4025.2252979278564,7348631,2599.5,7152550,0,196081
4027.2382934093475,7353300,2334.5,7157093,0,196207
4029.2397680282593,7358541,2620.5,7162189,0,196352
4031.2400574684143,7363820,2639.5,7167341,0,196479
4033.2542147636414,7368623,2401.5,7172010,0,196613
4035.2697825431824,7373790,2583.5,7177050,0,196740
4037.2749400138855,7379477,2843.5,7182599,0,196878
4039.284640312195,7384686,2604.5,7187653,0,197033
4041.293822288513,7388960,2137.0,7191831,0,197129
4043.3094387054443,7394632,2836.0,7197343,0,197289
4045.3095755577087,7400191,2779.5,7202762,0,197429
4047.320385694504,7405452,2630.5,7207882,0,197570
4049.3209159374237,7410802,2675.0,7213101,0,197701
4051.3364083766937,7415804,2501.0,7217968,0,197836
4053.342320203781,7420508,2352.0,7222561,0,197947
4055.3471763134003,7425172,2332.0,7227095,0,198077
4057.3477125167847,7430049,2438.5,7231861,0,198188
4059.356474161148,7434747,2349.0,7236433,0,198314
4061.3628284931183,7440531,2892.0,7242071,0,198460
4063.377278804779,7446148,2808.5,7247543,0,198605
4065.382584810257,7451238,2545.0,7252513,0,198725
4067.3840255737305,7456451,2606.5,7257586,0,198865
4069.39093875885,7461080,2314.5,7262093,0,198987
4071.4060764312744,7465903,2411.5,7266800,0,199103
4073.4269177913666,7469567,1832.0,7270370,0,199197
4075.433162212372,7474784,2608.5,7275434,0,199350
4077.448720216751,7479337,2276.5,7279865,0,199472
4079.448865175247,7483038,1850.5,7283465,0,199573
4081.456729412079,7488300,2631.0,7288622,0,199678
4083.4696459770203,7492893,2296.5,7293094,0,199799
4085.471712589264,7498471,2789.0,7298514,0,199957
4087.47931265831,7504148,2838.5,7304026,0,200122
4089.4857635498047,7509791,2821.5,7309539,0,200252
4091.4886713027954,7513801,2005.0,7313449,0,200352
4093.4919667243958,7516382,1290.5,7315956,0,200426
4095.507495164871,7521458,2538.0,7320893,0,200565
4097.523149728775,7527341,2941.5,7326605,0,200736
4099.5309245586395,7531653,2156.0,7330804,0,200849
4101.546550273895,7536720,2533.5,7335746,0,200974
4103.558811903,7541052,2166.0,7339971,0,201081
4105.558838605881,7546160,2554.0,7344956,0,201204
4107.574434518814,7550885,2362.5,7349554,0,201331
4109.576241970062,7555985,2550.0,7354536,0,201449
4111.590121269226,7561263,2639.0,7359690,0,201573
4113.592279434204,7566283,2510.0,7364567,0,201716
4115.602488279343,7570562,2139.5,7368725,0,201837
4117.608905076981,7575556,2497.0,7373586,0,201970
4119.610271453857,7580555,2499.5,7378445,0,202110
4121.618576288223,7584892,2168.5,7382671,0,202221
4123.623765468597,7589874,2491.0,7387512,0,202362
4125.639409542084,7595536,2831.0,7393024,0,202512
4127.640116214752,7600787,2625.5,7398133,0,202654
4129.64210152626,7606181,2697.0,7403378,0,202803
4131.645490407944,7610012,1915.5,7407103,0,202909
4133.660480737686,7614823,2405.5,7411785,0,203038
4135.667829990387,7620733,2955.0,7417552,0,203181
4137.672934293747,7625889,2578.0,7422576,0,203313
4139.680707216263,7630487,2299.0,7427083,0,203404
4141.6858468055725,7635903,2708.0,7432351,0,203552
4143.694666385651,7641384,2740.5,7437686,0,203698
4145.710301399231,7646536,2576.0,7442708,0,203828
4147.725818634033,7651323,2393.5,7447363,0,203960
4149.733016014099,7656515,2596.0,7452411,0,204104
4151.737482309341,7661912,2698.5,7457654,0,204258
4153.746973991394,7667011,2549.5,7462614,0,204397
4155.754055738449,7671940,2464.5,7467405,0,204535
4157.765918731689,7677416,2738.0,7472747,0,204669
4159.766613483429,7682835,2709.5,7478013,0,204822
4161.778794050217,7687846,2505.5,7482895,0,204951
4163.7918338775635,7692422,2288.0,7487351,0,205071
4165.798227548599,7696756,2167.0,7491591,0,205165
4167.7982358932495,7701827,2535.5,7496532,0,205295
4169.809587955475,7706413,2293.0,7500971,0,205442
4171.819093704224,7711769,2678.0,7506170,0,205599
4173.82398557663,7717627,2929.0,7511880,0,205747
4175.832901239395,7722981,2677.0,7517095,0,205886
4177.8477256298065,7728647,2833.0,7522606,0,206041
4179.856219768524,7733234,2293.5,7527065,0,206169
4181.866531133652,7736861,1813.5,7530606,0,206255
4183.867347955704,7741802,2470.5,7535413,0,206389
4185.87126159668,7747433,2815.5,7540892,0,206541
4187.886348247528,7752068,2317.5,7545398,0,206670
4189.894153594971,7757673,2802.5,7550842,0,206831
4191.895351886749,7763654,2990.5,7556654,0,207000
4193.8954911231995,7769763,3054.5,7562599,0,207164
4195.908044338226,7775021,2629.0,7567698,0,207323
4197.908446311951,7779301,2140.0,7571870,0,207431
4199.91500043869,7784507,2603.0,7576946,0,207561
4201.916404008865,7789026,2259.5,7581354,0,207672
4203.919389009476,7794460,2717.0,7586656,0,207804
4205.930952072144,7800340,2940.0,7592391,0,207949
4207.932706832886,7805550,2605.0,7597456,0,208094
4209.934650659561,7810412,2431.0,7602178,0,208234
4211.949464082718,7815723,2655.5,7607358,0,208365
4213.963344097137,7821676,2976.5,7613149,0,208527
4215.963345527649,7826666,2495.0,7617997,0,208669
4217.976589441299,7830346,1840.0,7621577,0,208769
4219.99063539505,7835238,2446.0,7626318,0,208920
4221.992294311523,7840356,2559.0,7631309,0,209047
4223.992294788361,7845546,2595.0,7636370,0,209176
4226.007891654968,7850581,2517.5,7641259,0,209322
4228.020277738571,7855851,2635.0,7646398,0,209453
4230.023284435272,7861527,2838.0,7651926,0,209601
4232.028656005859,7866201,2337.0,7656466,0,209735
4234.035108804703,7870699,2249.0,7660838,0,209861
4236.048398971558,7875094,2197.5,7665118,0,209976
4238.049659252167,7880710,2808.0,7670595,0,210115
4240.050477027893,7885513,2401.5,7675269,0,210244
4242.055093288422,7890756,2621.5,7680389,0,210367
4244.066551685333,7896337,2790.5,7685799,0,210538
4246.073349237442,7901666,2664.5,7690988,0,210678
4248.075648784637,7906338,2336.0,7695560,0,210778
4250.080296993256,7911383,2522.5,7700492,0,210891
4252.083633899689,7916744,2680.5,7705718,0,211026
4254.083645820618,7922054,2655.0,7710889,0,211165
4256.097070932388,7927270,2608.0,7715971,0,211299
4258.098954200745,7932964,2847.0,7721536,0,211428
4260.113682508469,7938205,2620.5,7726638,0,211567
4262.119834423065,7943579,2687.0,7731893,0,211686
4264.132111787796,7948572,2496.5,7736727,0,211845
4266.133154153824,7953749,2588.5,7741753,0,211996
4268.144584178925,7959273,2762.0,7747098,0,212175
4270.153068065643,7964304,2515.5,7751999,0,212305
4272.153253793716,7969685,2690.5,7757241,0,212444
4274.157884120941,7974966,2640.5,7762383,0,212583
4276.158668994904,7980784,2909.0,7768052,0,212732
4278.172039985657,7985222,2219.0,7772382,0,212840
4280.173792600632,7990401,2589.5,7777430,0,212971
4282.174171209335,7995894,2746.5,7782784,0,213110
4284.186558246613,8000778,2442.0,7787560,0,213218
4286.202139377594,8005439,2330.5,7792088,0,213351
4288.213584661484,8010856,2708.5,7797368,0,213488
4290.213667392731,8016638,2891.0,7802972,0,213666
4292.22931265831,8022201,2781.5,7808381,0,213820
4294.232935428619,8026738,2268.5,7812786,0,213952
4296.240605831146,8030302,1782.0,7816241,0,214061
4298.248930454254,8035696,2697.0,7821501,0,214195
4300.252777099609,8040088,2196.0,7825764,0,214324
4302.25367975235,8045687,2799.5,7831225,0,214462
4304.264136314392,8050829,2571.0,7836241,0,214588
4306.2644164562225,8056110,2640.5,7841363,0,214747
4308.26672744751,8060776,2333.0,7845904,0,214872
4310.267489433289,8065073,2148.5,7850116,0,214957
4312.280246019363,8069936,2431.5,7854886,0,215050
4314.282353878021,8075041,2552.5,7859856,0,215185
4316.2851126194,8080155,2557.0,7864816,0,215339
4318.293170452118,8085326,2585.5,7869872,0,215454
4320.294239759445,8090384,2529.0,7874806,0,215578
4322.300590276718,8095811,2713.5,7880091,0,215720
4324.3072600364685,8100934,2561.5,7885086,0,215848
4326.316958665848,8105815,2440.5,7889837,0,215978
4328.317883491516,8110954,2569.5,7894829,0,216125
4330.331269741058,8116785,2915.5,7900508,0,216277
4332.346893548965,8122805,3010.0,7906363,0,216442
4334.352553129196,8128190,2692.5,7911606,0,216584
4336.367433786392,8133620,2715.0,7916901,0,216719
4338.380685567856,8139115,2747.5,7922257,0,216858
4340.383414030075,8144235,2560.0,7927240,0,216995
4342.393547296524,8149641,2703.0,7932520,0,217121
4344.396359920502,8154510,2434.5,7937263,0,217247
4346.405016422272,8160352,2921.0,7942937,0,217415
4348.405323982239,8165897,2772.5,7948343,0,217554
4350.414399147034,8171188,2645.5,7953513,0,217675
4352.417805194855,8176707,2759.5,7958904,0,217803
4354.4213144779205,8181631,2462.0,7963685,0,217946
4356.4310755729675,8186342,2355.5,7968286,0,218056
4358.441842794418,8191808,2733.0,7973626,0,218182
4360.448444843292,8197288,2740.0,7978980,0,218308
4362.4494750499725,8202602,2657.0,7984146,0,218456
4364.4583904743195,8207953,2675.5,7989368,0,218585
4366.464505195618,8212628,2337.5,7993914,0,218714
4368.477274417877,8218127,2749.5,7999266,0,218861
4370.492896318436,8224122,2997.5,8005096,0,219026
4372.502717494965,8229356,2617.0,8010218,0,219138
4374.511763095856,8235205,2924.5,8015907,0,219298
4376.512888431549,8241132,2963.5,8021685,0,219447
4378.528526306152,8247098,2983.0,8027499,0,219599
4380.541481733322,8252079,2490.5,8032350,0,219729
4382.557206630707,8257214,2567.5,8037343,0,219871
4384.5673677921295,8262679,2732.5,8042673,0,220006
4386.573879003525,8268205,2763.0,8048059,0,220146
4388.583670377731,8273303,2549.0,8053048,0,220255
4390.599222898483,8278597,2647.0,8058214,0,220383
4392.61106967926,8284025,2714.0,8063492,0,220533
4394.6266922950745,8289626,2800.5,8068959,0,220667
4396.626742601395,8294413,2393.5,8073614,0,220799
4398.64253115654,8299433,2510.0,8078496,0,220937
4400.645606994629,8304712,2639.5,8083640,0,221072
4402.647214412689,8309207,2247.5,8088024,0,221183
4404.657940864563,8314572,2682.5,8093257,0,221315
4406.659397125244,8320121,2774.5,8098676,0,221445
4408.66481089592,8325720,2799.5,8104107,0,221613
4410.679943561554,8331536,2908.0,8109772,0,221764
4412.683680295944,8337151,2807.5,8115254,0,221897
4414.694100618362,8342661,2755.0,8120613,0,222048
4416.709772348404,8348347,2843.0,8126162,0,222185
4418.711431503296,8353826,2739.5,8131500,0,222326
4420.7266619205475,8358838,2506.0,8136378,0,222460
4422.7340359687805,8364187,2674.5,8141583,0,222604
4424.739000558853,8369898,2855.5,8147134,0,222764
4426.740289449692,8375367,2734.5,8152457,0,222910
4428.755957841873,8380342,2487.5,8157295,0,223047
4430.762799978256,8385552,2605.0,8162369,0,223183
4432.77830696106,8391550,2999.0,8168205,0,223345
4434.782067060471,8397260,2855.0,8173759,0,223501
4436.786863327026,8402189,2464.5,8178565,0,223624
4438.789087772369,8407379,2595.0,8183609,0,223770
4440.791499376297,8413014,2817.5,8189099,0,223915
4442.8064341545105,8418601,2793.5,8194544,0,224057
4444.808876276016,8423615,2507.0,8199440,0,224175
4446.814301729202,8428710,2547.5,8204402,0,224308
4448.827743053436,8434052,2671.0,8209589,0,224463
4450.835235118866,8439305,2626.5,8214696,0,224609
4452.850708723068,8444470,2582.5,8219730,0,224740
4454.8517854213715,8449561,2545.5,8224673,0,224888
4456.855941534042,8455071,2755.0,8230024,0,225047
4458.860632181168,8460386,2657.5,8235192,0,225194
4460.876256465912,8466329,2971.5,8240975,0,225354
4462.884397029877,8472054,2862.5,8246539,0,225515
4464.899177312851,8477842,2894.0,8252180,0,225662
4466.9102902412415,8483665,2911.5,8257840,0,225825
4468.92417383194,8489361,2848.0,8263403,0,225958
4470.926127672195,8495121,2880.0,8269011,0,226110
4472.939996957779,8501156,3017.5,8274891,0,226265
4474.9448935985565,8506625,2734.5,8280209,0,226416
4476.948996305466,8512309,2842.0,8285755,0,226554
4478.950581789017,8518033,2862.0,8291325,0,226708
4480.9547283649445,8523978,2972.5,8297109,0,226869
4482.954754829407,8529812,2917.0,8302786,0,227026
4484.956504583359,8534490,2339.0,8307348,0,227142
4486.962325811386,8536994,1252.0,8309774,0,227220
4488.9731233119965,8540177,1591.5,8312884,0,227293
4490.977949142456,8546064,2943.5,8318606,0,227458
4492.983639240265,8551795,2865.5,8324187,0,227608
4494.999227523804,8556167,2186.0,8328445,0,227722
4497.0116646289825,8562030,2931.5,8334190,0,227840
4499.025349378586,8567473,2721.5,8339493,0,227980
4501.033631324768,8573015,2771.0,8344868,0,228147
4503.041857004166,8578814,2899.5,8350509,0,228305
4505.041950941086,8584720,2953.0,8356255,0,228465
4507.053865671158,8590481,2880.5,8361872,0,228609
4509.066069364548,8596214,2866.5,8367472,0,228742
4511.080675125122,8602155,2970.5,8373259,0,228896
4513.080676078796,8607614,2729.5,8378558,0,229056
4515.096369743347,8613486,2936.0,8384289,0,229197
4517.105353355408,8619458,2986.0,8390070,0,229388
4519.106313228607,8625237,2889.5,8395704,0,229533
4521.120382785797,8631110,2936.5,8401424,0,229686
4523.132098674774,8636992,2941.0,8407151,0,229841
4525.132836103439,8642681,2844.5,8412705,0,229976
4527.140366792679,8648411,2865.0,8418267,0,230144
4529.155969619751,8654440,3014.5,8424135,0,230305
4531.164247512817,8660099,2829.5,8429643,0,230456
4533.179164171219,8666019,2960.0,8435400,0,230619
4535.186826705933,8671536,2758.5,8440769,0,230767
4537.199760437012,8677460,2962.0,8446536,0,230924
4539.20649766922,8683280,2910.0,8452204,0,231076
4541.20854473114,8688738,2729.0,8457501,0,231237
4543.2097799777985,8693639,2450.5,8462273,0,231366
4545.210953950882,8698786,2573.5,8467258,0,231528
4547.215813159943,8704296,2755.0,8472625,0,231671
4549.220151424408,8710195,2949.5,8478370,0,231825
4551.220854520798,8716204,3004.5,8484212,0,231992
4553.229034662247,8721900,2848.0,8489771,0,232129
4555.238754034042,8727804,2952.0,8495527,0,232277
4557.249482154846,8733838,3017.0,8501414,0,232424
4559.261926651001,8739775,2968.5,8507214,0,232561
4561.275421380997,8745658,2941.5,8512956,0,232702
4563.277125597,8751668,3005.0,8518805,0,232863
4565.279580831528,8757669,3000.5,8524630,0,233039
4567.280563592911,8763639,2985.0,8530446,0,233193
4569.286788702011,8769588,2974.5,8536235,0,233353
4571.302222967148,8775733,3072.5,8542213,0,233520
4573.304847478867,8781142,2704.5,8547479,0,233663
4575.319168329239,8784854,1856.0,8551113,0,233741
4577.333636045456,8789519,2332.5,8555659,0,233860
4579.3337190151215,8794440,2460.5,8560447,0,233993
4581.343466997147,8798871,2215.5,8564755,0,234116
4583.348529815674,8804502,2815.5,8570246,0,234256
4585.348538160324,8808992,2245.0,8574605,0,234387
4587.357112169266,8814419,2713.5,8579871,0,234548
4589.36856007576,8820010,2795.5,8585326,0,234684
4591.377497911453,8825744,2867.0,8590920,0,234824
4593.388563871384,8830715,2485.5,8595755,0,234960
4595.397515296936,8835299,2292.0,8600218,0,235081
4597.408050537109,8840698,2699.5,8605474,0,235224
4599.418586492538,8845145,2223.5,8609782,0,235363
4601.4263920784,8849582,2218.5,8614115,0,235467
4603.4267141819,8854362,2390.0,8618752,0,235610
4605.431521177292,8859796,2717.0,8624035,0,235761
4607.438439130783,8864786,2495.0,8628889,0,235897
4609.450039625168,8869585,2399.5,8633554,0,236031
4611.4542717933655,8874581,2498.0,8638414,0,236167
4613.464360952377,8879242,2330.5,8642958,0,236284
4615.474045038223,8884084,2421.0,8647664,0,236420
4617.486173152924,8888621,2268.5,8652082,0,236539
4619.488574504852,8893813,2596.0,8657145,0,236668
4621.5040690898895,8899622,2904.5,8662803,0,236819
4623.512251615524,8904613,2495.5,8667659,0,236954
4625.523688077927,8909051,2219.0,8671988,0,237063
4627.53918337822,8914297,2623.0,8677093,0,237204
4629.54504442215,8919333,2518.0,8681992,0,237341
4631.554185628891,8924222,2444.5,8686761,0,237461
4633.561814069748,8929331,2554.5,8691729,0,237602
4635.565402269363,8933374,2021.5,8695668,0,237706
4637.579190015793,8938907,2766.5,8701044,0,237863
4639.5846338272095,8942511,1802.0,8704551,0,237960
4641.586853504181,8947530,2509.5,8709434,0,238096
4643.596853733063,8952623,2546.5,8714390,0,238233
4645.60780787468,8956573,1975.0,8718241,0,238332
4647.612954378128,8962369,2898.0,8723883,0,238486
4649.625203371048,8967141,2386.0,8728541,0,238600
4651.638132810593,8972723,2791.0,8733971,0,238752
4653.643155574799,8978475,2876.0,8739570,0,238905
4655.652903079987,8983238,2381.5,8744203,0,239035
4657.668413639069,8988884,2823.0,8749693,0,239191
4659.668828010559,8994866,2991.0,8755501,0,239365
4661.675330162048,9000287,2710.5,8760792,0,239495
4663.680902719498,9005537,2625.0,8765902,0,239635
4665.695927619934,9010847,2655.0,8771084,0,239763
4667.710255622864,9015708,2430.5,8775831,0,239877
4669.713494539261,9021476,2884.0,8781450,0,240026
4671.72358083725,9026541,2532.5,8786381,0,240160
4673.73232460022,9031826,2642.5,8791533,0,240293
4675.733338356018,9036997,2585.5,8796564,0,240433
4677.747447490692,9042897,2950.0,8802318,0,240579
4679.7562601566315,9048174,2638.5,8807455,0,240719
4681.759174108505,9053064,2445.0,8812228,0,240836
4683.760033607483,9058748,2842.0,8817779,0,240969
4685.761157512665,9064450,2851.0,8823318,0,241132
4687.776644706726,9069961,2755.5,8828685,0,241276
4689.782544374466,9075243,2641.0,8833824,0,241419
4691.792977809906,9080271,2514.0,8838724,0,241547
4693.806683301926,9085494,2611.5,8843803,0,241691
4695.816465377808,9091193,2849.5,8849341,0,241852
4697.826068878174,9096086,2446.5,8854106,0,241980
4699.827613353729,9101241,2577.5,8859135,0,242106
4701.830605506897,9105474,2116.5,8863269,0,242205
4703.832166671753,9108626,1576.0,8866344,0,242282
4705.833471775055,9113527,2450.5,8871133,0,242394
4707.8471965789795,9118552,2512.5,8876026,0,242526
4709.8598527908325,9124483,2965.5,8881795,0,242688
4711.868269443512,9129117,2317.0,8886315,0,242802
4713.871489286423,9134023,2453.0,8891111,0,242912
4715.887116909027,9139012,2494.5,8895970,0,243042
4717.895796775818,9144893,2940.5,8901683,0,243210
4719.899289131165,9150291,2699.0,8906925,0,243366
4721.904005289078,9155283,2496.0,8911769,0,243514
4723.914801359177,9160570,2643.5,8916907,0,243663
4725.930450201035,9166435,2932.5,8922604,0,243831
4727.942713975906,9171825,2695.0,8927840,0,243985
4729.94727563858,9176951,2563.0,8932823,0,244128
4731.947445392609,9182505,2777.0,8938225,0,244280
4733.949724674225,9188020,2757.5,8943591,0,244429
4735.95618057251,9193171,2575.5,8948619,0,244552
4737.968571186066,9198045,2437.0,8953363,0,244682
4739.969108343124,9202553,2254.0,8957741,0,244812
4741.969614982605,9207511,2479.0,8962592,0,244919
4743.974558591843,9212959,2724.0,8967916,0,245043
4745.9874057769775,9218333,2687.0,8973150,0,245183
4747.998643159866,9223783,2725.0,8978461,0,245322
4750.000025510788,9229974,3095.5,8984474,0,245500
4752.00350522995,9234428,2227.0,8988818,0,245610
4754.013696908951,9239624,2598.0,8993878,0,245746
4756.018479347229,9245054,2715.0,8999171,0,245883
4758.019680976868,9250869,2907.5,9004836,0,246033
4760.021361112595,9255596,2363.5,9009445,0,246151
4762.0276074409485,9260460,2432.0,9014184,0,246276
4764.037505149841,9265812,2676.0,9019393,0,246419
4766.048609495163,9271561,2874.5,9024986,0,246575
4768.06368970871,9276853,2646.0,9030146,0,246707
4770.078490018845,9281753,2450.0,9034910,0,246843
4772.091936349869,9287044,2645.5,9040061,0,246983
4774.09983754158,9292115,2535.5,9044998,0,247117
4776.105935335159,9297128,2506.5,9049875,0,247253
4778.120819330215,9301271,2071.5,9053930,0,247341
4780.132830381393,9306275,2502.0,9058787,0,247488
4782.142798900604,9311739,2732.0,9064102,0,247637
4784.143409252167,9317100,2680.5,9069317,0,247783
4786.151047468185,9321600,2250.0,9073706,0,247894
4788.160831451416,9326574,2487.0,9078542,0,248032
4790.16729927063,9332277,2851.5,9084098,0,248179
4792.176807403564,9337625,2674.0,9089298,0,248327
4794.18069934845,9342550,2462.5,9094096,0,248454
4796.185271501541,9347707,2578.5,9099141,0,248566
4798.190092086792,9352102,2197.5,9103397,0,248705
4800.2019510269165,9357565,2731.5,9108715,0,248850
4802.205722570419,9362090,2262.5,9113114,0,248976
4804.206827640533,9367256,2583.0,9118129,0,249127
4806.2083196640015,9371475,2109.5,9122231,0,249244
4808.21809720993,9376694,2609.5,9127320,0,249374
4810.219123601913,9381982,2644.0,9132503,0,249479
4812.220784902573,9386979,2498.5,9137369,0,249610
4814.229944229126,9393046,3033.5,9143263,0,249783
4816.2463529109955,9398103,2528.5,9148188,0,249915
4818.262565612793,9402323,2110.0,9152295,0,250028
4820.273838043213,9407528,2602.5,9157367,0,250161
4822.284711122513,9413000,2736.0,9162705,0,250295
4824.289799928665,9417657,2328.5,9167236,0,250421
4826.294968128204,9422372,2357.5,9171832,0,250540
4828.309673070908,9427157,2392.5,9176473,0,250684
4830.32076215744,9430552,1697.5,9179767,0,250785
4832.332779169083,9436054,2751.0,9185113,0,250941
4834.34499502182,9441110,2528.0,9190039,0,251071
4836.354818344116,9445850,2370.0,9194641,0,251209
4838.366383075714,9449868,2009.0,9198558,0,251310
4840.376537799835,9455130,2631.0,9203671,0,251459
4842.380153656006,9459985,2427.5,9208375,0,251610
4844.3907380104065,9465484,2749.5,9213724,0,251760
4846.401339530945,9470502,2509.0,9218608,0,251894
4848.41649389267,9475488,2493.0,9223441,0,252047
4850.424622297287,9479712,2112.0,9227554,0,252158
4852.426800251007,9484721,2504.5,9232442,0,252279
4854.437272787094,9490390,2834.5,9237979,0,252411
4856.448593616486,9495844,2727.0,9243281,0,252563
4858.456144809723,9500468,2312.0,9247792,0,252676
4860.471566915512,9504829,2180.5,9252046,0,252783
4862.472728013992,9510108,2639.5,9257198,0,252910
4864.48065161705,9514720,2306.0,9261684,0,253036
4866.492389917374,9519431,2355.5,9266255,0,253176
4868.503635883331,9525185,2877.0,9271875,0,253310
4870.5149974823,9529825,2320.0,9276380,0,253445
4872.529101371765,9534413,2294.0,9280853,0,253560
4874.539612770081,9539482,2534.5,9285791,0,253691
4876.552659988403,9544898,2708.0,9291065,0,253833
4878.564087629318,9550233,2667.5,9296269,0,253964
4880.575768232346,9555091,2429.0,9301011,0,254080
4882.578814744949,9559883,2396.0,9305676,0,254207
4884.589834213257,9565209,2663.0,9310868,0,254341
4886.6006808280945,9570947,2869.0,9316443,0,254504
4888.611802101135,9576090,2571.5,9321455,0,254635
4890.61368060112,9580921,2415.5,9326153,0,254768
4892.624741792679,9585873,2476.0,9330961,0,254912
4894.6319851875305,9591048,2587.5,9335996,0,255052
4896.643790483475,9596823,2887.5,9341607,0,255216
4898.657354354858,9601773,2475.0,9346426,0,255347
4900.668169975281,9607457,2842.0,9351966,0,255491
4902.6723074913025,9612402,2472.5,9356784,0,255618
4904.673797607422,9617124,2361.0,9361383,0,255741
4906.682046890259,9621320,2098.0,9365463,0,255857
4908.693431138992,9626676,2678.0,9370680,0,255996
4910.695281028748,9631878,2601.0,9375743,0,256135
4912.712054491043,9637271,2696.5,9380997,0,256274
4914.7279188632965,9642966,2847.5,9386554,0,256412
4916.7366733551025,9648059,2546.5,9391497,0,256562
4918.744484424591,9653043,2492.0,9396343,0,256700
4920.755093097687,9658970,2963.5,9402112,0,256858
4922.756111860275,9663780,2405.0,9406810,0,256970
4924.770545005798,9668759,2489.5,9411653,0,257106
4926.774521350861,9674015,2628.0,9416775,0,257240
4928.787574291229,9679473,2729.0,9422089,0,257384
4930.799078941345,9683977,2252.0,9426475,0,257502
4932.8124051094055,9689141,2582.0,9431517,0,257624
4934.822838783264,9693223,2041.0,9435480,0,257743
4936.833562374115,9697371,2074.0,9439524,0,257847
4938.840878486633,9702402,2515.5,9444423,0,257979
4940.8422429561615,9707015,2306.5,9448917,0,258098
4942.858790636063,9711245,2115.0,9453036,0,258209
4944.868828058243,9716150,2452.5,9457812,0,258338
4946.88084769249,9721285,2567.5,9462810,0,258475
4948.883574485779,9725898,2306.5,9467300,0,258598
4950.891947746277,9730963,2532.5,9472241,0,258722
4952.902593612671,9736151,2594.0,9477290,0,258861
4954.906285047531,9740366,2107.5,9481391,0,258975
4956.919853925705,9745975,2804.5,9486850,0,259125
4958.93120098114,9751244,2634.5,9491978,0,259266
4960.9452838897705,9755745,2250.5,9496338,0,259407
4962.961493015289,9758267,1261.0,9498806,0,259461
4964.972530126572,9762998,2365.5,9503406,0,259592
4966.987424135208,9768312,2657.0,9508589,0,259723
4968.998390674591,9772672,2180.0,9512827,0,259845
4971.0022740364075,9776837,2082.5,9516889,0,259948
4973.015120983124,9782556,2859.5,9522462,0,260094
4975.025990724564,9787954,2699.0,9527719,0,260235
4977.036753416061,9793339,2692.5,9532966,0,260373
4979.047734260559,9798272,2466.5,9537761,0,260511
4981.059175729752,9803693,2710.5,9543033,0,260660
4983.071126699448,9809348,2827.5,9548543,0,260805
4985.081154584885,9814207,2429.5,9553281,0,260926
4987.086481809616,9819232,2512.5,9558173,0,261059
4989.099551200867,9824833,2800.5,9563629,0,261204
4991.110309123993,9830669,2918.0,9569321,0,261348
4993.111180305481,9835906,2618.5,9574436,0,261470
4995.123011112213,9840723,2408.5,9579114,0,261609
4997.1329617500305,9845748,2512.5,9584006,0,261742
4999.14075422287,9851220,2736.0,9589347,0,261873
5001.151920080185,9856254,2517.0,9594242,0,262012
5003.159670352936,9861649,2697.5,9599497,0,262152
5005.16521191597,9866908,2629.5,9604621,0,262287
5007.175902843475,9872896,2994.0,9610453,0,262443
5009.177676200867,9877227,2165.5,9614672,0,262555
5011.19082570076,9882867,2820.0,9620168,0,262699
5013.196174860001,9888146,2639.5,9625308,0,262838
5015.224112033844,9892487,2170.5,9629526,0,262961
5017.235358953476,9897124,2318.5,9634060,0,263064
5019.244280576706,9902006,2441.0,9638802,0,263204
5021.259234189987,9907655,2824.5,9644289,0,263366
5023.2698674201965,9912838,2591.5,9649334,0,263504
5025.275693178177,9917519,2340.5,9653855,0,263664
5027.276377439499,9923069,2775.0,9659257,0,263812
5029.2847282886505,9928980,2955.5,9665020,0,263960
5031.296573400497,9933804,2412.0,9669732,0,264072
5033.304462194443,9939633,2914.5,9675395,0,264238
5035.3137283325195,9945522,2944.5,9681120,0,264402
5037.324538707733,9951497,2987.5,9686954,0,264543
5039.331878900528,9956087,2295.0,9691413,0,264674
5041.3387632369995,9961091,2502.0,9696267,0,264824
5043.345883369446,9966137,2523.0,9701170,0,264967
5045.3582582473755,9971420,2641.5,9706321,0,265099
5047.369794130325,9976195,2387.5,9710982,0,265213
5049.385824203491,9981260,2532.5,9715923,0,265337
5051.397491455078,9986781,2760.5,9721319,0,265462
5053.4084322452545,9991909,2564.0,9726309,0,265600
5055.423057556152,9996369,2230.0,9730674,0,265695
5057.43890953064,10001220,2425.5,9735377,0,265843
5059.451673984528,10006158,2469.0,9740195,0,265963
5061.463688135147,10010788,2315.0,9744675,0,266113
5063.471381664276,10014292,1752.0,9748081,0,266211
5065.473171234131,10015814,761.0,9749549,0,266265
5067.483727455139,10015814,0.0,9749549,0,266265
5069.4899826049805,10018768,1477.0,9752438,0,266330
5071.503702640533,10023375,2303.5,9756936,0,266439
5073.517434597015,10027855,2240.0,9761305,0,266550
5075.529979944229,10031850,1997.5,9765190,0,266660
5077.541562795639,10035567,1858.5,9768813,0,266754
5079.555947303772,10040736,2584.5,9773851,0,266885
5081.569310665131,10046175,2719.5,9779132,0,267043
5083.582227706909,10050947,2386.0,9783763,0,267184
5085.585839271545,10056028,2540.5,9788733,0,267295
5087.594338417053,10061277,2624.5,9793847,0,267430
5089.595808506012,10065084,1903.5,9797562,0,267522
5091.610837459564,10067796,1356.0,9800207,0,267589
5093.620289564133,10072671,2437.5,9804958,0,267713
5095.629659175873,10077827,2578.0,9809983,0,267844
5097.645218133926,10083217,2695.0,9815234,0,267983
5099.654378414154,10087990,2386.5,9819880,0,268110
5101.667561531067,10093018,2514.0,9824757,0,268261
5103.6760993003845,10098156,2569.0,9829750,0,268406
5105.679761886597,10103964,2904.0,9835393,0,268571
5107.691373348236,10109366,2701.0,9840646,0,268720
5109.706565618515,10114469,2551.5,9845623,0,268846
5111.711939334869,10120126,2828.5,9851121,0,269005
5113.723912000656,10125976,2925.0,9856814,0,269162
5115.725500822067,10131459,2741.5,9862148,0,269311
5117.733965396881,10136808,2674.5,9867358,0,269450
5119.745808839798,10141829,2510.5,9872255,0,269574
5121.755677461624,10147425,2798.0,9877696,0,269729
5123.762136459351,10153185,2880.0,9883322,0,269863
5125.770370006561,10157776,2295.5,9887810,0,269966
5127.783532619476,10163019,2621.5,9892915,0,270104
5129.791573762894,10167907,2444.0,9897676,0,270231
5131.80565237999,10172955,2524.0,9902589,0,270366
5133.81978058815,10177837,2441.0,9907349,0,270488
5135.833410978317,10182552,2357.5,9911925,0,270627
5137.84809422493,10188220,2834.0,9917452,0,270768
5139.852557897568,10193208,2494.0,9922319,0,270889
5141.866055011749,10197875,2333.5,9926861,0,271014
5143.878803730011,10203101,2613.0,9931927,0,271174
5145.882555484772,10208715,2807.0,9937380,0,271335
5147.894116401672,10214444,2864.5,9942945,0,271499
5149.904757261276,10219358,2457.0,9947728,0,271630
5151.917093515396,10224277,2459.5,9952523,0,271754
5153.930686950684,10230121,2922.0,9958225,0,271896
5155.935209274292,10235769,2824.0,9963716,0,272053
5157.938333034515,10241434,2832.5,9969228,0,272206
5159.949117422104,10246193,2379.5,9973862,0,272331
5161.960347175598,10251275,2541.0,9978817,0,272458
5163.97043633461,10256358,2541.5,9983766,0,272592
5165.983020544052,10261515,2578.5,9988787,0,272728
5167.993152141571,10266674,2579.5,9993814,0,272860
5169.998665332794,10272370,2848.0,9999379,0,272991
5172.006406784058,10278265,2947.5,10005108,0,273157
5174.018388748169,10283660,2697.5,10010369,0,273291
5176.031635761261,10288705,2522.5,10015280,0,273425
5178.044196367264,10294246,2770.5,10020678,0,273568
5180.055137634277,10299557,2655.5,10025854,0,273703
5182.068948507309,10304542,2492.5,10030712,0,273830
5184.081570863724,10310150,2804.0,10036180,0,273970
5186.093648195267,10315842,2846.0,10041713,0,274129
5188.1006672382355,10320903,2530.5,10046620,0,274283
5190.112126111984,10326056,2576.5,10051641,0,274415
5192.119873762131,10330912,2428.0,10056388,0,274524
5194.133305072784,10335902,2495.0,10061248,0,274654
5196.137185573578,10340826,2462.0,10066054,0,274772
5198.142627477646,10345669,2421.5,10070760,0,274909
5200.147096395493,10350363,2347.0,10075332,0,275031
5202.159175157547,10355746,2691.5,10080572,0,275174
5204.162048339844,10360353,2303.5,10085049,0,275304
5206.174926042557,10365451,2549.0,10090013,0,275438
5208.189877748489,10369957,2253.0,10094404,0,275553
5210.201955318451,10374388,2215.5,10098713,0,275675
5212.215571403503,10379191,2401.5,10103388,0,275803
5214.228315353394,10383795,2302.0,10107870,0,275925
5216.242183685303,10389003,2604.0,10112945,0,276058
5218.251923561096,10394183,2590.0,10117990,0,276193
5220.253319263458,10398735,2276.0,10122417,0,276318
5222.2616975307465,10403943,2604.0,10127488,0,276455
5224.2732989788055,10409410,2733.5,10132809,0,276601
5226.280409812927,10415029,2809.5,10138279,0,276750
5228.292602777481,10420312,2641.5,10143427,0,276885
5230.307381868362,10425699,2693.5,10148676,0,277023
5232.321451425552,10430911,2606.0,10153736,0,277175
5234.335692167282,10436200,2644.5,10158890,0,277310
5236.3468635082245,10441703,2751.5,10164229,0,277474
5238.355248451233,10446418,2357.5,10168806,0,277612
5240.366314411163,10451383,2482.5,10173638,0,277745
5242.369617462158,10456918,2767.5,10179026,0,277892
5244.3851935863495,10462288,2685.0,10184263,0,278025
5246.398415088654,10467824,2768.0,10189651,0,278173
5248.412353515625,10471583,1879.5,10193313,0,278270
5250.414191484451,10475757,2087.0,10197372,0,278385
5252.418000459671,10480721,2482.0,10202216,0,278505
5254.4288721084595,10484742,2010.5,10206137,0,278605
5256.44021821022,10489717,2487.5,10210975,0,278742
5258.442308664322,10493829,2056.0,10214973,0,278856
5260.454281806946,10499251,2711.0,10220245,0,279006
5262.461401462555,10503823,2286.0,10224693,0,279130
5264.462826967239,10509499,2838.0,10230216,0,279283
5266.477949380875,10515244,2872.5,10235825,0,279419
5268.489019155502,10520165,2460.5,10240594,0,279571
5270.502754688263,10524953,2394.0,10245242,0,279711
5272.508389949799,10529660,2353.5,10249841,0,279819
5274.520629405975,10535124,2732.0,10255162,0,279962
5276.527843475342,10541027,2951.5,10260906,0,280121
5278.541050672531,10546487,2730.0,10266222,0,280265
5280.5562744140625,10551390,2451.5,10270993,0,280397
5282.571651697159,10557420,3015.0,10276877,0,280543
5284.583166360855,10563314,2947.0,10282626,0,280688
5286.595298528671,10568400,2543.0,10287569,0,280831
5288.596227884293,10574011,2805.5,10293030,0,280981
5290.609092235565,10580051,3020.0,10298903,0,281148
5292.619799375534,10585773,2861.0,10304453,0,281320
5294.630856513977,10591400,2813.5,10309917,0,281483
5296.644878864288,10596446,2523.0,10314839,0,281607
5298.654327869415,10601774,2664.0,10320022,0,281752
5300.662753343582,10606275,2250.5,10324407,0,281868
5302.673739433289,10612039,2882.0,10330030,0,282009
5304.685218095779,10616879,2420.0,10334750,0,282129
5306.696140289307,10621491,2306.0,10339250,0,282241
5308.708202123642,10627077,2793.0,10344693,0,282384
5310.722284317017,10632485,2704.0,10349941,0,282544
5312.726962804794,10636914,2214.5,10354247,0,282667
5314.73629784584,10641497,2291.5,10358704,0,282793
5316.7387046813965,10647109,2806.0,10364181,0,282928
5318.752333164215,10652333,2612.0,10369281,0,283052
5320.752806663513,10656810,2238.5,10373632,0,283178
5322.765890598297,10661900,2545.0,10378594,0,283306
5324.777069091797,10667915,3007.5,10384445,0,283470
5326.787267923355,10673017,2551.0,10389431,0,283586
5328.793909072876,10678751,2867.0,10395009,0,283742
5330.804764509201,10684411,2830.0,10400515,0,283896
5332.8168070316315,10690447,3018.0,10406403,0,284044
5334.831573724747,10695846,2699.5,10411671,0,284175
5336.834846496582,10701339,2746.5,10417030,0,284309
5338.846061706543,10705316,1988.5,10420911,0,284405
5340.858256816864,10710589,2636.5,10426023,0,284566
5342.860025405884,10714938,2174.5,10430256,0,284682
5344.8697056770325,10720062,2562.0,10435258,0,284804
5346.882235765457,10724951,2444.5,10439998,0,284953
5348.893129110336,10730700,2874.5,10445584,0,285116
5350.901572942734,10736355,2827.5,10451065,0,285290
5352.909424543381,10741265,2455.0,10455866,0,285399
5354.916264772415,10746157,2446.0,10460646,0,285511
5356.927172899246,10752341,3092.0,10466671,0,285670
5358.929980516434,10757394,2526.5,10471607,0,285787
5360.933120965958,10761809,2207.5,10475896,0,285913
5362.941559553146,10767560,2875.5,10481507,0,286053
5364.946027994156,10772991,2715.5,10486791,0,286200
5366.957843065262,10778404,2706.5,10492048,0,286356
5368.973502874374,10783522,2559.0,10497019,0,286503
5370.9844880104065,10789376,2927.0,10502728,0,286648
5372.995064735413,10795142,2883.0,10508343,0,286799
5375.00580406189,10799140,1999.0,10512250,0,286890
5377.021373510361,10804234,2547.0,10517226,0,287008
5379.028536558151,10809425,2595.5,10522283,0,287142
5381.039404630661,10814328,2451.5,10527052,0,287276
5383.055322170258,10819171,2421.5,10531769,0,287402
5385.066310882568,10824959,2894.0,10537409,0,287550
5387.073467254639,10830132,2586.5,10542443,0,287689
5389.088388681412,10835744,2806.0,10547895,0,287849
5391.09445142746,10840777,2516.5,10552812,0,287965
5393.107531309128,10846343,2783.0,10558206,0,288137
5395.111680269241,10851708,2682.5,10563432,0,288276
5397.123445272446,10856690,2491.0,10568297,0,288393
5399.127070188522,10861427,2368.5,10572917,0,288510
5401.1283004283905,10866636,2604.5,10577986,0,288650
5403.13975071907,10872031,2697.5,10583226,0,288805
5405.142395973206,10876758,2363.5,10587842,0,288916
5407.145957708359,10882213,2727.5,10593139,0,289074
5409.156225681305,10887446,2616.5,10598241,0,289205
5411.159163951874,10893007,2780.5,10603640,0,289367
5413.167680501938,10898250,2621.5,10608725,0,289525
5415.183612823486,10903574,2662.0,10613934,0,289640
5417.200135469437,10908613,2519.5,10618856,0,289757
5419.208892822266,10914196,2791.5,10624298,0,289898
5421.219191074371,10919363,2583.5,10629331,0,290032
5423.220412969589,10924548,2592.5,10634376,0,290172
5425.236389636993,10929611,2531.5,10639326,0,290285
5427.247402191162,10935477,2933.0,10645043,0,290434
5429.254066944122,10940846,2684.5,10650271,0,290575
5431.267077922821,10945727,2440.5,10655016,0,290711
5433.278182983398,10950684,2478.5,10659851,0,290833
5435.2854471206665,10955060,2188.0,10664109,0,290951
5437.299191951752,10959971,2455.5,10668885,0,291086
5439.313719034195,10964788,2408.5,10673592,0,291196
5441.316239833832,10970056,2634.0,10678717,0,291339
5443.318884372711,10975110,2527.0,10683626,0,291484
5445.3200924396515,10980936,2913.0,10689292,0,291644
5447.3310379981995,10986485,2774.5,10694674,0,291811
5449.336529254913,10991236,2375.5,10699317,0,291919
5451.340430498123,10996704,2734.0,10704635,0,292069
5453.352158069611,11002616,2956.0,10710388,0,292228
5455.365172863007,11008048,2716.0,10715691,0,292357
5457.371492147446,11012369,2160.5,10719895,0,292474
5459.382712125778,11015473,1552.0,10722930,0,292543
5461.393615961075,11020067,2297.0,10727394,0,292673
5463.399640083313,11024911,2422.0,10732103,0,292808
5465.404905319214,11030354,2721.5,10737418,0,292936
5467.408867359161,11035931,2788.5,10742851,0,293080
5469.411910295486,11041724,2896.5,10748485,0,293239
5471.423838853836,11047081,2678.5,10753697,0,293384
5473.432877779007,11051727,2323.0,10758233,0,293494
5475.448099374771,11057132,2702.5,10763490,0,293642
5477.4544467926025,11062552,2710.0,10768758,0,293794
5479.46771812439,11067847,2647.5,10773901,0,293946
5481.480042219162,11072811,2482.0,10778738,0,294073
5483.492367267609,11077990,2589.5,10783760,0,294230
5485.4939506053925,11083400,2705.0,10789027,0,294373
5487.50904417038,11088739,2669.5,10794218,0,294521
5489.525702238083,11092308,1784.5,10797713,0,294595
5491.536948442459,11097172,2432.0,10802444,0,294728
5493.552340745926,11102015,2421.5,10807171,0,294844
5495.564640045166,11106637,2311.0,10811661,0,294976
5497.575576305389,11111921,2642.0,10816814,0,295107
5499.587551355362,11116902,2490.5,10821678,0,295224
5501.602580547333,11122242,2670.0,10826880,0,295362
5503.609388589859,11127041,2399.5,10831550,0,295491
5505.621310472488,11132467,2713.0,10836834,0,295633
5507.6356728076935,11138295,2914.0,10842519,0,295776
5509.649739265442,11143730,2717.5,10847806,0,295924
5511.651171207428,11148553,2411.5,10852499,0,296054
5513.6618366241455,11153000,2223.5,10856818,0,296182
5515.677476644516,11158310,2655.0,10861981,0,296329
5517.692353010178,11163960,2825.0,10867476,0,296484
5519.707445383072,11168455,2247.5,10871845,0,296610
5521.718070030212,11173333,2439.0,10876584,0,296749
5523.72097158432,11178393,2530.0,10881506,0,296887
5525.721694946289,11183439,2523.0,10886426,0,297013
5527.727314949036,11188475,2518.0,10891347,0,297128
5529.733718156815,11193814,2669.5,10896539,0,297275
5531.749499082565,11199226,2706.0,10901817,0,297409
5533.753745794296,11204737,2755.5,10907172,0,297565
5535.764037132263,11209592,2427.5,10911901,0,297691
5537.775124311447,11214142,2275.0,10916325,0,297817
5539.7856092453,11219107,2482.5,10921164,0,297943
5541.798533201218,11224489,2691.0,10926402,0,298087
5543.807989597321,11229921,2716.0,10931684,0,298237
5545.81950879097,11234730,2404.5,10936387,0,298343
5547.832902908325,11239555,2412.5,10941078,0,298477
5549.848582983017,11245311,2878.0,10946689,0,298622
5551.859235525131,11251000,2844.5,10952240,0,298760
5553.872343540192,11255953,2476.5,10957070,0,298883
5555.884523630142,11260898,2472.5,10961903,0,298995
5557.899908065796,11265967,2534.5,10966838,0,299129
5559.904030561447,11271016,2524.5,10971732,0,299284
5561.913912296295,11275241,2112.5,10975854,0,299387
5563.921339273453,11280492,2625.5,10980980,0,299512
5565.933913946152,11286030,2769.0,10986380,0,299650
5567.947564125061,11291025,2497.5,10991246,0,299779
5569.957742214203,11295465,2220.0,10995569,0,299896
5571.967542171478,11300563,2549.0,11000541,0,300022
5573.979647397995,11306284,2860.5,11006104,0,300180
5575.991633653641,11311371,2543.5,11011069,0,300302
5578.001284599304,11315900,2264.5,11015476,0,300424
5580.011050224304,11320540,2320.0,11019997,0,300543
5582.014593362808,11326028,2744.0,11025337,0,300691
5584.025445699692,11331083,2527.5,11030259,0,300824
5586.0287566185,11335973,2445.0,11035018,0,300955
5588.041241168976,11342007,3017.0,11040890,0,301117
5590.053416252136,11347322,2657.5,11046067,0,301255
5592.056568622589,11351973,2325.5,11050577,0,301396
5594.067836284637,11357021,2524.0,11055513,0,301508
5596.0773911476135,11362729,2854.0,11061077,0,301652
5598.089464426041,11368372,2821.5,11066561,0,301811
5600.104966878891,11373373,2500.5,11071420,0,301953
5602.111982584,11378042,2334.5,11075974,0,302068
5604.127734422684,11383079,2518.5,11080869,0,302210
5606.1423053741455,11388492,2706.5,11086142,0,302350
5608.155249834061,11393406,2457.0,11090937,0,302469
5610.161851167679,11398231,2412.5,11095634,0,302597
5612.164249897003,11403242,2505.5,11100500,0,302742
5614.166876077652,11408125,2441.5,11105237,0,302888
5616.1893882751465,11413176,2525.5,11110157,0,303019
5618.192219734192,11417720,2272.0,11114584,0,303136
5620.1996483802795,11422853,2566.5,11119587,0,303266
5622.213234424591,11428821,2984.0,11125400,0,303421
5624.214160203934,11433162,2170.5,11129613,0,303549
5626.217385053635,11438097,2467.5,11134428,0,303669
5628.227985620499,11444046,2974.5,11140245,0,303801
5630.2403955459595,11449640,2797.0,11145701,0,303939
5632.251139640808,11454810,2585.0,11150738,0,304072
5634.260582685471,11460634,2912.0,11156424,0,304210
5636.272867679596,11466048,2707.0,11161697,0,304351
5638.281963348389,11471053,2502.5,11166566,0,304487
5640.289086103439,11474608,1777.5,11170021,0,304587
5642.300106287003,11480015,2703.5,11175275,0,304740
5644.307390451431,11485429,2707.0,11180551,0,304878
5646.311942815781,11490693,2632.0,11185676,0,305017
5648.318753480911,11495627,2467.0,11190495,0,305132
5650.321875333786,11499754,2063.5,11194532,0,305222
5652.338185310364,11504839,2542.5,11199473,0,305366
5654.3524518013,11509698,2429.5,11204207,0,305491
5656.358011484146,11513347,1824.5,11207766,0,305581
5658.360974311829,11518578,2615.5,11212858,0,305720
5660.362622499466,11523300,2361.0,11217432,0,305868
5662.36732339859,11528627,2663.5,11222633,0,305994
5664.37865281105,11533795,2584.0,11227668,0,306127
5666.385270118713,11539316,2760.5,11233028,0,306288
5668.399645805359,11544889,2786.5,11238440,0,306449
5670.401747941971,11549929,2520.0,11243355,0,306574
5672.404541015625,11555584,2827.5,11248852,0,306732
5674.415321826935,11560189,2302.5,11253350,0,306839
5676.423820972443,11565622,2716.5,11258646,0,306976
5678.42652463913,11570003,2190.5,11262909,0,307094
5680.43665766716,11575022,2509.5,11267799,0,307223
5682.441302061081,11580382,2680.0,11273023,0,307359
5684.457460165024,11585564,2591.0,11278060,0,307504
5686.466876268387,11590448,2442.0,11282816,0,307632
5688.477921485901,11595519,2535.5,11287754,0,307765
5690.482602357864,11600893,2687.0,11293004,0,307889
5692.488419294357,11606603,2855.0,11298561,0,308042
5694.498871564865,11611045,2221.0,11302873,0,308172
5696.501474142075,11616196,2575.5,11307885,0,308311
5698.507115602493,11621328,2566.0,11312869,0,308459
5700.518259763718,11626954,2813.0,11318341,0,308613
5702.53045296669,11632337,2691.5,11323584,0,308753
5704.537368297577,11637615,2639.0,11328719,0,308896
5706.5449655056,11642954,2669.5,11333905,0,309049
5708.5466430187225,11648776,2911.0,11339584,0,309192
5710.560272932053,11654285,2754.5,11344955,0,309330
5712.568453550339,11659281,2498.0,11349818,0,309463
5714.581885576248,11664881,2800.0,11355274,0,309607
5716.5890073776245,11670835,2977.0,11361081,0,309754
5718.60186624527,11675651,2408.0,11365781,0,309870
5720.615561723709,11681083,2716.0,11371071,0,310012
5722.623281478882,11686202,2559.5,11376043,0,310159
5724.636548757553,11691627,2712.5,11381312,0,310315
5726.6506135463715,11696605,2489.0,11386158,0,310447
5728.659864902496,11701844,2619.5,11391246,0,310598
5730.671589374542,11707180,2668.0,11396444,0,310736
5732.684058189392,11712320,2570.0,11401457,0,310863
5734.687133073807,11716819,2249.5,11405837,0,310982
5736.694909095764,11721807,2494.0,11410683,0,311124
5738.7010979652405,11727332,2762.5,11416054,0,311278
5740.712097406387,11731815,2241.5,11420392,0,311423
5742.713497161865,11736481,2333.0,11424924,0,311557
5744.717747211456,11741644,2581.5,11429965,0,311679
5746.7274396419525,11746649,2502.5,11434843,0,311806
5748.7322306633,11751226,2288.5,11439285,0,311941
5750.739052295685,11756833,2803.5,11444763,0,312070
5752.7455632686615,11761824,2495.5,11449621,0,312203
5754.761431932449,11767303,2739.5,11454960,0,312343
5756.772987604141,11771956,2326.5,11459493,0,312463
5758.788597345352,11776798,2421.0,11464206,0,312592
5760.801018714905,11781812,2507.0,11469086,0,312726
5762.8060047626495,11786855,2521.5,11473997,0,312858
5764.807487487793,11791143,2144.0,11478159,0,312984
5766.817352771759,11796536,2696.5,11483411,0,313125
5768.829022884369,11802285,2874.5,11489021,0,313264
5770.83976149559,11807734,2724.5,11494332,0,313402
5772.850366353989,11812420,2343.0,11498888,0,313532
5774.864060163498,11818039,2809.5,11504358,0,313681
5776.8771414756775,11823416,2688.5,11509583,0,313833
5778.8853096961975,11829196,2890.0,11515185,0,314011
5780.897585868835,11833980,2392.0,11519835,0,314145
5782.908689498901,11839110,2565.0,11524832,0,314278
5784.919377326965,11844579,2734.5,11530155,0,314424
5786.930940389633,11849470,2445.5,11534906,0,314564
5788.93355345726,11854243,2386.5,11539545,0,314698
5790.944747686386,11858479,2118.0,11543670,0,314809
5792.950265407562,11862681,2101.0,11547764,0,314917
5794.953257322311,11867109,2214.0,11552075,0,315034
5796.958115339279,11872131,2511.0,11556934,0,315197
5798.969140768051,11877413,2641.0,11562070,0,315343
5800.973587036133,11882771,2679.0,11567284,0,315487
5802.985720157623,11887815,2522.0,11572189,0,315626
5804.996863126755,11892056,2120.5,11576300,0,315756
5807.003670215607,11896897,2420.5,11581025,0,315872
5809.019210577011,11902397,2750.0,11586379,0,316018
5811.031928062439,11907637,2620.0,11591482,0,316155
5813.0438187122345,11912537,2450.0,11596261,0,316276
5815.047409057617,11917501,2482.0,11601085,0,316416
5817.049624919891,11922612,2555.5,11606073,0,316539
5819.052070140839,11926023,1705.5,11609393,0,316630
5821.06303691864,11930049,2013.0,11613313,0,316736
5823.075800180435,11934897,2424.0,11618015,0,316882
5825.081615686417,11940161,2632.0,11623155,0,317006
5827.096605539322,11945164,2501.5,11628027,0,317137
5829.109655618668,11950009,2422.5,11632753,0,317256
5831.121337890625,11955937,2964.0,11638513,0,317424
5833.133556842804,11961422,2742.5,11643850,0,317572
5835.14315867424,11965316,1947.0,11647644,0,317672
5837.153827428818,11970352,2518.0,11652534,0,317818
5839.160816192627,11974382,2015.0,11656451,0,317931
5841.17099571228,11979528,2573.0,11661482,0,318046
5843.185312271118,11984357,2414.5,11666181,0,318176
5845.199739694595,11989935,2789.0,11671621,0,318314
5847.207903146744,11995631,2848.0,11677185,0,318446
5849.211578607559,11998393,1381.0,11679864,0,318529
5851.222848415375,12000599,1103.0,11682024,0,318575
5853.2375366687775,12004796,2098.5,11686116,0,318680
5855.25109577179,12009633,2418.5,11690813,0,318820
5857.261801242828,12014838,2602.5,11695890,0,318948
5859.265539884567,12020164,2663.0,11701086,0,319078
5861.277284145355,12025340,2588.0,11706126,0,319214
5863.28995513916,12030751,2705.5,11711399,0,319352
5865.302489995956,12035613,2431.0,11716139,0,319474
5867.318480014801,12041000,2693.5,11721393,0,319607
5869.327584981918,12045004,2002.0,11725286,0,319718
5871.332545757294,12049780,2388.0,11729928,0,319852
5873.340997695923,12053964,2092.0,11733993,0,319971
5875.345534563065,12058203,2119.5,11738136,0,320067
5877.35925412178,12064022,2909.5,11743791,0,320231
5879.366211414337,12069112,2545.0,11748748,0,320364
5881.367438077927,12074057,2472.5,11753561,0,320496
5883.3757066726685,12079364,2653.5,11758719,0,320645
5885.383052825928,12084438,2537.0,11763636,0,320802
5887.387420892715,12089867,2714.5,11768910,0,320957
5889.392902851105,12094631,2382.0,11773553,0,321078
5891.405702352524,12100015,2692.0,11778775,0,321240
5893.410898447037,12105618,2801.5,11784207,0,321411
5895.4159870147705,12111173,2777.5,11789623,0,321550
5897.418845653534,12116254,2540.5,11794568,0,321686
5899.432976961136,12120871,2308.5,11799066,0,321805
5901.435083389282,12126229,2679.0,11804290,0,321939
5903.441128730774,12131859,2815.0,11809761,0,322098
5905.455708265305,12137427,2784.0,11815161,0,322266
5907.469375371933,12142473,2523.0,11820078,0,322395
5909.485232591629,12148276,2901.5,11825702,0,322574
5911.495882034302,12153575,2649.5,11830861,0,322714
5913.509762048721,12158668,2546.5,11835823,0,322845
5915.512154579163,12163414,2373.0,11840437,0,322977
5917.526167869568,12168812,2699.0,11845673,0,323139
5919.530656576157,12174118,2653.0,11850834,0,323284
5921.54451918602,12179084,2483.0,11855676,0,323408
5923.555609464645,12184279,2597.5,11860751,0,323528
5925.559442996979,12189642,2681.5,11865980,0,323662
5927.564417600632,12194904,2631.0,11871117,0,323787
5929.577995061874,12199346,2221.0,11875445,0,323901
5931.591994524002,12204856,2755.0,11880797,0,324059
5933.6055772304535,12210372,2758.0,11886174,0,324198
5935.616390943527,12215656,2642.0,11891314,0,324342
5937.629283428192,12220542,2443.0,11896078,0,324464
5939.631252527237,12225953,2705.5,11901334,0,324619
5941.63592004776,12231720,2883.5,11906957,0,324763
5943.636733531952,12236370,2325.0,11911491,0,324879
5945.647789478302,12241147,2388.5,11916147,0,325000
5947.659460306168,12245947,2400.0,11920821,0,325126
5949.663729190826,12251220,2636.5,11925956,0,325264
5951.674719333649,12257059,2919.5,11931655,0,325404
5953.686411380768,12262327,2634.0,11936795,0,325532
5955.6917552948,12267395,2534.0,11941731,0,325664
5957.703718662262,12273165,2885.0,11947351,0,325814
5959.718670129776,12278378,2606.5,11952418,0,325960
5961.731466054916,12283305,2463.5,11957231,0,326074
5963.745124101639,12288632,2663.5,11962428,0,326204
5965.758630275726,12293519,2443.5,11967185,0,326334
5967.771597146988,12299195,2838.0,11972711,0,326484
5969.7726855278015,12303984,2394.5,11977383,0,326601
5971.7838768959045,12308727,2371.5,11981994,0,326733
5973.79824757576,12314065,2669.0,11987200,0,326865
5975.801261425018,12318111,2023.0,11991136,0,326975
5977.815351724625,12322789,2339.0,11995701,0,327088
5979.828518152237,12328129,2670.0,12000905,0,327224
5981.840628623962,12333043,2457.0,12005707,0,327336
5983.851894617081,12338159,2558.0,12010692,0,327467
5985.862482070923,12343219,2530.0,12015627,0,327592
5987.87681889534,12348265,2523.0,12020530,0,327735
5989.87776517868,12353846,2790.5,12025990,0,327856
5991.888098716736,12359252,2703.0,12031252,0,328000
5993.903697729111,12364873,2810.5,12036714,0,328159
5995.905440568924,12369722,2424.5,12041444,0,328278
5997.913277387619,12374914,2596.0,12046524,0,328390
5999.921881914139,12380610,2848.0,12052083,0,328527
6001.933995485306,12385639,2514.5,12056980,0,328659
6003.942731618881,12389587,1974.0,12060821,0,328766
6005.955510854721,12395040,2726.5,12066129,0,328911
6007.9621641635895,12399986,2473.0,12070931,0,329055
6009.976129055023,12404554,2284.0,12075392,0,329162
6011.982027053833,12410096,2771.0,12080776,0,329320
6013.990730762482,12415791,2847.5,12086313,0,329478
6015.995908737183,12421471,2840.0,12091844,0,329627
6018.000143527985,12426441,2485.0,12096682,0,329759
6020.01115322113,12431794,2676.5,12101891,0,329903
6022.022206068039,12437279,2742.5,12107234,0,330045
6024.029978752136,12442794,2757.5,12112587,0,330207
6026.043930530548,12448258,2732.0,12117898,0,330360
6028.055891036987,12453199,2470.5,12122707,0,330492
6030.065170049667,12456814,1807.5,12126229,0,330585
6032.066150426865,12461937,2561.5,12131229,0,330708
6034.067705869675,12467447,2755.0,12136583,0,330864
6036.068645477295,12472494,2523.5,12141511,0,330983
6038.0799334049225,12477471,2488.5,12146357,0,331114
6040.092482805252,12482634,2581.5,12151382,0,331252
6042.093578338623,12487506,2436.0,12156143,0,331363
6044.104104042053,12492296,2395.0,12160814,0,331482
6046.111998558044,12497364,2534.0,12165772,0,331592
6048.12463760376,12502996,2816.0,12171236,0,331760
6050.130690097809,12508448,2726.0,12176544,0,331904
6052.136543750763,12513441,2496.5,12181409,0,332032
6054.1482989788055,12518539,2549.0,12186390,0,332149
6056.149305343628,12523428,2444.5,12191168,0,332260
6058.163980484009,12528753,2662.5,12196364,0,332389
6060.178534030914,12533071,2159.0,12200565,0,332506
6062.179972171783,12538328,2628.5,12205670,0,332658
6064.192838668823,12543491,2581.5,12210707,0,332784
6066.203878164291,12548650,2579.5,12215736,0,332914
6068.216263771057,12553605,2477.5,12220577,0,333028
6070.231557369232,12558639,2517.0,12225474,0,333165
6072.234382867813,12564562,2961.5,12231241,0,333321
6074.250109672546,12569884,2661.0,12236427,0,333457
6076.262319326401,12574938,2527.0,12241348,0,333590
6078.266211986542,12579412,2237.0,12245701,0,333711
6080.279642343521,12584449,2518.5,12250602,0,333847
6082.283255577087,12589893,2722.0,12255884,0,334009
6084.2900857925415,12594906,2506.5,12260758,0,334148
6086.295843839645,12599256,2175.0,12265003,0,334253
6088.306993484497,12604972,2858.0,12270570,0,334402
6090.307548284531,12610169,2598.5,12275629,0,334540
6092.31689786911,12614473,2152.0,12279804,0,334669
6094.32128405571,12618856,2191.5,12284070,0,334786
6096.325611114502,12622825,1984.5,12287947,0,334878
6098.337811470032,12628196,2685.5,12293189,0,335007
6100.352952480316,12633046,2425.0,12297905,0,335141
6102.353575229645,12637407,2180.5,12302157,0,335250
6104.365777015686,12642662,2627.5,12307262,0,335400
6106.377469778061,12648510,2924.0,12312967,0,335543
6108.38631272316,12653493,2491.5,12317824,0,335669
6110.398638486862,12658308,2407.5,12322498,0,335810
6112.403490304947,12663473,2582.5,12327506,0,335967
6114.406483888626,12668762,2644.5,12332669,0,336093
6116.407575130463,12671898,1568.0,12335729,0,336169
6118.412092447281,12675260,1681.0,12338993,0,336267
6120.423234939575,12679670,2205.0,12343291,0,336379
6122.435289382935,12684876,2603.0,12348365,0,336511
6124.439024686813,12689884,2504.0,12353231,0,336653
6126.440486192703,12694372,2244.0,12357602,0,336770
6128.449392080307,12699286,2457.0,12362391,0,336895
6130.460524559021,12704466,2590.0,12367439,0,337027
6132.462778091431,12709953,2743.5,12372792,0,337161
6134.4735951423645,12715198,2622.5,12377913,0,337285
6136.482214927673,12720287,2544.5,12382860,0,337427
6138.49276804924,12725696,2704.5,12388128,0,337568
6140.503413200378,12730244,2274.0,12392539,0,337705
6142.507571935654,12735086,2421.0,12397273,0,337813
6144.518828392029,12740443,2678.5,12402482,0,337961
6146.530803203583,12745735,2646.0,12407636,0,338099
6148.539020061493,12751209,2737.0,12412975,0,338234
6150.542988538742,12756387,2589.0,12418032,0,338355
6152.556885242462,12761528,2570.5,12423043,0,338485
6154.571346998215,12766216,2344.0,12427621,0,338595
6156.5847001075745,12770841,2312.5,12432124,0,338717
6158.59964632988,12776187,2673.0,12437302,0,338885
6160.614438533783,12781396,2604.5,12442391,0,339005
6162.619205236435,12786314,2459.0,12447181,0,339133
6164.630820512772,12791361,2523.5,12452093,0,339268
6166.631465673447,12796697,2668.0,12457301,0,339396
6168.639183759689,12802729,3016.0,12463201,0,339528
6170.655246496201,12807217,2244.0,12467584,0,339633
6172.66685795784,12812339,2561.0,12472565,0,339774
6174.679843902588,12817552,2606.5,12477636,0,339916
6176.684914827347,12823206,2827.0,12483107,0,340099
6178.6981728076935,12827659,2226.5,12487443,0,340216
6180.713845491409,12832617,2479.0,12492271,0,340346
6182.7281329631805,12838338,2860.5,12497848,0,340490
6184.740204572678,12843483,2572.5,12502847,0,340636
6186.746175765991,12848446,2481.5,12507670,0,340776
6188.74968624115,12854146,2850.0,12513203,0,340943
6190.751195907593,12859800,2827.0,12518708,0,341092
6192.7634973526,12864925,2562.5,12523697,0,341228
6194.768286705017,12869867,2471.0,12528503,0,341364
6196.771712064743,12875282,2707.5,12533800,0,341482
6198.780190706253,12880547,2632.5,12538917,0,341630
6200.782340764999,12885487,2470.0,12543737,0,341750
6202.797369480133,12890637,2575.0,12548762,0,341875
6204.803873538971,12895912,2637.5,12553898,0,342014
6206.819483995438,12901237,2662.5,12559096,0,342141
6208.833318471909,12906267,2515.0,12563986,0,342281
6210.835515737534,12911891,2812.0,12569476,0,342415
6212.846754789352,12917101,2605.0,12574540,0,342561
6214.852967739105,12922102,2500.5,12579394,0,342708
6216.868443012238,12926717,2307.5,12583885,0,342832
6218.876608848572,12931514,2398.5,12588564,0,342950
6220.88062953949,12936644,2565.0,12593569,0,343075
6222.893488168716,12942135,2745.5,12598935,0,343200
6224.893672466278,12947784,2824.5,12604429,0,343355
6226.897244215012,12951769,1992.5,12608305,0,343464
6228.900013923645,12956548,2389.5,12612949,0,343599
6230.912082195282,12961732,2592.0,12618000,0,343732
6232.9256455898285,12966686,2477.0,12622817,0,343869
6234.939800262451,12971297,2305.5,12627299,0,343998
6236.951512813568,12976462,2582.5,12632328,0,344134
6238.958611726761,12981921,2729.5,12637634,0,344287
6240.962108135223,12987186,2632.5,12642753,0,344433
6242.965193986893,12991522,2168.0,12646984,0,344538
6244.976981639862,12996872,2675.0,12652210,0,344662
6246.97886800766,13002265,2696.5,12657470,0,344795
6248.99312877655,13006580,2157.5,12661662,0,344918
6251.008267879486,13010900,2160.0,12665875,0,345025
6253.018876791,13016432,2766.0,12671266,0,345166
6255.020164728165,13021733,2650.5,12676433,0,345300
6257.025323152542,13026560,2413.5,12681118,0,345442
6259.03931927681,13031279,2359.5,12685716,0,345563
6261.039452791214,13036320,2520.5,12690636,0,345684
6263.050258159637,13040640,2160.0,12694849,0,345791
6265.058744430542,13045511,2435.5,12699597,0,345914
6267.063481807709,13050561,2525.0,12704521,0,346040
6269.073257684708,13055829,2634.0,12709649,0,346180
6271.08450961113,13061012,2591.5,12714705,0,346307
6273.088558912277,13066857,2922.5,12720406,0,346451
6275.102385044098,13071411,2277.0,12724859,0,346552
6277.103549480438,13076636,2612.5,12729956,0,346680
6279.113733768463,13080965,2164.5,12734177,0,346788
6281.115392208099,13086229,2632.0,12739268,0,346961
6283.116573810577,13091191,2481.0,12744100,0,347091
6285.117347478867,13096718,2763.5,12749479,0,347239
6287.117798089981,13101612,2447.0,12754248,0,347364
6289.119658946991,13106526,2457.0,12759055,0,347471
6291.12212228775,13112267,2870.5,12764644,0,347623
6293.122123241425,13117116,2424.5,12769363,0,347753
6295.137769699097,13122170,2527.0,12774267,0,347903
6297.147334098816,13127104,2467.0,12779082,0,348022
6299.14812207222,13132114,2505.0,12783952,0,348162
6301.151213884354,13137928,2907.0,12789624,0,348304
6303.151559829712,13142220,2146.0,12793813,0,348407
6305.156131029129,13146997,2388.5,12798481,0,348516
6307.157272338867,13152905,2954.0,12804225,0,348680
6309.157778739929,13158254,2674.5,12809428,0,348826
6311.157861232758,13162877,2311.5,12813934,0,348943
6313.16152381897,13166028,1575.5,12816982,0,349046
6315.177132606506,13171687,2829.5,12822504,0,349183
6317.192757844925,13177275,2794.0,12827942,0,349333
6319.193425893784,13181567,2146.0,12832112,0,349455
6321.194190502167,13187002,2717.5,12837396,0,349606
6323.194191455841,13192184,2591.0,12842449,0,349735
6325.197040557861,13197527,2671.5,12847658,0,349869
6327.197159051895,13202582,2527.5,12852569,0,350013
6329.209602594376,13208060,2739.0,12857900,0,350160
6331.210458278656,13213458,2699.0,12863168,0,350290
6333.2245099544525,13218390,2466.0,12867959,0,350431
6335.22749710083,13222786,2198.0,12872232,0,350554
6337.229510545731,13227753,2483.5,12877073,0,350680
6339.2304944992065,13233007,2627.0,12882185,0,350822
6341.23278260231,13238208,2600.5,12887251,0,350957
6343.234146356583,13243342,2567.0,12892259,0,351083
6345.234996557236,13247876,2267.0,12896672,0,351204
6347.250538825989,13253520,2822.0,12902156,0,351364
6349.251995801926,13258535,2507.5,12907025,0,351510
6351.259487628937,13262983,2224.0,12911363,0,351620
6353.260881662369,13268527,2772.0,12916756,0,351771
6355.262167453766,13273531,2502.0,12921623,0,351908
6357.264721393585,13278879,2674.0,12926837,0,352042
6359.267842531204,13283776,2448.5,12931602,0,352174
6361.2715973854065,13288680,2452.0,12936381,0,352299
6363.274780988693,13293068,2194.0,12940659,0,352409
6365.278455495834,13298153,2542.5,12945609,0,352544
6367.295688867569,13302981,2414.0,12950289,0,352692
6369.311200618744,13307953,2486.0,12955137,0,352816
6371.311601638794,13312705,2376.0,12959765,0,352940
6373.324079275131,13318436,2865.5,12965349,0,353087
6375.339678525925,13323014,2289.0,12969814,0,353200
6377.340117931366,13328283,2634.5,12974959,0,353324
6379.342433929443,13333866,2791.5,12980424,0,353442
6381.34582901001,13338685,2409.5,12985103,0,353582
6383.354780197144,13343509,2412.0,12989805,0,353704
6385.354780435562,13348610,2550.5,12994776,0,353834
6387.355861186981,13353847,2618.5,12999878,0,353969
6389.366246938705,13359158,2655.5,13005041,0,354117
6391.366872787476,13364723,2782.5,13010443,0,354280
6393.374037265778,13369731,2504.0,13015324,0,354407
6395.376291275024,13374682,2475.5,13020178,0,354504
6397.378504276276,13380282,2800.0,13025616,0,354666
6399.389294624329,13384849,2283.5,13030066,0,354783
6401.389596223831,13389744,2447.5,13034830,0,354914
6403.398920059204,13395248,2752.0,13040212,0,355036
6405.4023678302765,13400754,2753.0,13045592,0,355162
6407.408370018005,13404815,2030.5,13049547,0,355268
6409.415595293045,13410056,2620.5,13054637,0,355419
6411.416437387466,13415118,2531.0,13059559,0,355559
6413.416930913925,13420686,2784.0,13064983,0,355703
6415.418967723846,13425613,2463.5,13069788,0,355825
6417.422451734543,13430113,2250.0,13074174,0,355939
6419.427154779434,13435223,2555.0,13079145,0,356078
6421.4283809661865,13440029,2403.0,13083816,0,356213
6423.431901931763,13444517,2244.0,13088181,0,356336
6425.435703277588,13449322,2402.5,13092846,0,356476
6427.451335906982,13453308,1993.0,13096740,0,356568
6429.451455116272,13458667,2679.5,13101948,0,356719
6431.460267543793,13463356,2344.5,13106515,0,356841
6433.460942983627,13467766,2205.0,13110808,0,356958
6435.475077390671,13473070,2652.0,13115965,0,357105
6437.475214958191,13477781,2355.5,13120571,0,357210
6439.486144781113,13480711,1465.0,13123432,0,357279
6441.491185665131,13486138,2713.5,13128731,0,357407
6443.496511220932,13491230,2546.0,13133686,0,357544
6445.497919559479,13495958,2364.0,13138292,0,357666
6447.498537778854,13500617,2329.5,13142821,0,357796
6449.503019332886,13504787,2085.0,13146874,0,357913
6451.505742073059,13510475,2844.0,13152406,0,358069
6453.51625585556,13512838,1181.5,13154718,0,358120
6455.5221383571625,13515097,1129.5,13156912,0,358185
6457.522887468338,13520263,2583.0,13161950,0,358313
6459.527073383331,13524421,2079.0,13166004,0,358417
6461.537816524506,13529440,2509.5,13170897,0,358543
6463.553658723831,13534155,2357.5,13175493,0,358662
6465.558271884918,13539048,2446.5,13180241,0,358807
6467.573874950409,13543585,2268.5,13184647,0,358938
6469.575687408447,13548652,2533.5,13189593,0,359059
6471.588952064514,13553601,2474.5,13194411,0,359190
6473.592373371124,13558349,2374.0,13199039,0,359310
6475.607995271683,13563407,2529.0,13203960,0,359447
6477.616231441498,13568335,2464.0,13208760,0,359575
6479.629080295563,13572762,2213.5,13213064,0,359698
6481.642994403839,13577973,2605.5,13218139,0,359834
6483.642996788025,13583257,2642.0,13223302,0,359955
6485.654780387878,13587750,2246.5,13227674,0,360076
6487.66473698616,13592806,2528.0,13232614,0,360192
6489.665170669556,13598143,2668.5,13237796,0,360347
6491.674082040787,13602783,2320.0,13242315,0,360468
6493.675258159637,13607451,2334.0,13246861,0,360590
6495.680462360382,13612351,2450.0,13251636,0,360715
6497.683138370514,13617727,2688.0,13256859,0,360868
6499.69158244133,13623018,2645.5,13262005,0,361013
6501.696600675583,13628422,2702.0,13267274,0,361148
6503.7002148628235,13632692,2135.0,13271420,0,361272
6505.705721855164,13637424,2366.0,13276020,0,361404
6507.71240234375,13643083,2829.5,13281553,0,361530
6509.729394197464,13648037,2477.0,13286374,0,361663
6511.740741252899,13653008,2485.5,13291222,0,361786
6513.751361131668,13657971,2481.5,13296066,0,361905
6515.751889705658,13662930,2479.5,13300894,0,362036
6517.76611828804,13668458,2764.0,13306280,0,362178
6519.77919459343,13672647,2094.5,13310353,0,362294
6521.789663314819,13677793,2573.0,13315377,0,362416
6523.791100740433,13683622,2914.5,13321071,0,362551
6525.791928529739,13688777,2577.5,13326118,0,362659
6527.797371864319,13693632,2427.5,13330829,0,362803
6529.812358379364,13698536,2452.0,13335606,0,362930
6531.821038722992,13703924,2694.0,13340838,0,363086
6533.826832294464,13709200,2638.0,13345983,0,363217
6535.829408168793,13713258,2029.0,13349932,0,363326
6537.843480348587,13718991,2866.5,13355517,0,363474
6539.84502696991,13724018,2513.5,13360398,0,363620
6541.851271152496,13729096,2539.0,13365342,0,363754
6543.857895374298,13733902,2403.0,13370044,0,363858
6545.858314275742,13739586,2842.0,13375588,0,363998
6547.8619821071625,13744878,2646.0,13380744,0,364134
6549.867845535278,13749781,2451.5,13385521,0,364260
6551.871888637543,13755418,2818.5,13390989,0,364429
6553.872488737106,13760727,2654.5,13396158,0,364569
6555.882600069046,13766407,2840.0,13401679,0,364728
6557.890915155411,13771552,2572.5,13406695,0,364857
6559.89715886116,13776214,2331.0,13411240,0,364974
6561.905676603317,13781113,2449.5,13415993,0,365120
6563.91533946991,13786480,2683.5,13421210,0,365270
6565.921093702316,13791222,2371.0,13425832,0,365390
6567.92758846283,13796255,2516.5,13430747,0,365508
6569.933258295059,13801809,2777.0,13436160,0,365649
6571.934517145157,13806547,2369.0,13440756,0,365791
6573.934528589249,13811764,2608.5,13445851,0,365913
6575.94527220726,13816350,2293.0,13450312,0,366038
6577.9459574222565,13821250,2450.0,13455085,0,366165
6579.9463567733765,13826154,2452.0,13459837,0,366317
6581.957317113876,13831305,2575.5,13464864,0,366441
6583.9580228328705,13836118,2406.5,13469546,0,366572
6585.9623811244965,13840826,2354.0,13474135,0,366691
6587.972236633301,13845949,2561.5,13479130,0,366819
6589.973166942596,13851340,2695.5,13484377,0,366963
6591.987482070923,13854511,1585.5,13487460,0,367051
6593.994510650635,13859028,2258.5,13491851,0,367177
6595.997590780258,13864473,2722.5,13497156,0,367317
6598.0120232105255,13870178,2852.5,13502711,0,367467
6600.0248601436615,13874472,2147.0,13506890,0,367582
6602.027946949005,13878600,2064.0,13510899,0,367701
6604.028753519058,13883755,2577.5,13515929,0,367826
6606.032092809677,13888912,2578.5,13520951,0,367961
6608.037642478943,13893167,2127.5,13525096,0,368071
6610.038408756256,13898433,2633.0,13530224,0,368209
6612.054030656815,13904240,2903.5,13535880,0,368360
6614.055144071579,13909643,2701.5,13541150,0,368493
6616.064420223236,13914466,2411.5,13545871,0,368595
6618.064629077911,13919573,2553.5,13550843,0,368730
6620.073035240173,13924993,2710.0,13556139,0,368854
6622.074608802795,13930506,2756.5,13561505,0,369001
6624.077816486359,13934643,2068.5,13565533,0,369110
6626.07878780365,13939845,2601.0,13570599,0,369246
6628.07998418808,13945502,2828.5,13576099,0,369403
6630.081291675568,13950842,2670.0,13581303,0,369539
6632.094856977463,13955630,2394.0,13585983,0,369647
6634.096351861954,13959206,1788.0,13589463,0,369743
6636.0984008312225,13964035,2414.5,13594179,0,369856
6638.105271816254,13968910,2437.5,13598919,0,369991
6640.120339155197,13973066,2078.0,13602966,0,370100
6642.121622562408,13978235,2584.5,13608008,0,370227
6644.122050046921,13984301,3033.0,13613914,0,370387
6646.124354124069,13989586,2642.5,13619065,0,370521
6648.139926433563,13994140,2277.0,13623483,0,370657
6650.141154050827,13999898,2879.0,13629103,0,370795
6652.142822980881,14005485,2793.5,13634531,0,370954
6654.143072605133,14010023,2269.0,13638951,0,371072
6656.14718580246,14014956,2466.5,13643760,0,371196
6658.157125234604,14018523,1783.5,13647234,0,371289
6660.15727519989,14023755,2616.0,13652337,0,371418
6662.168433189392,14029009,2627.0,13657439,0,371570
6664.18340921402,14033916,2453.5,13662219,0,371697
6666.194262981415,14038209,2146.5,13666398,0,371811
6668.196713209152,14043992,2891.5,13672029,0,371963
6670.19820857048,14049461,2734.5,13677361,0,372100
6672.2005088329315,14055004,2771.5,13682784,0,372220
6674.201519727707,14061022,3009.0,13688641,0,372381
6676.206008434296,14066883,2930.5,13694343,0,372540
6678.214529275894,14071666,2391.5,13699006,0,372660
6680.216049194336,14077219,2776.5,13704402,0,372817
6682.223678827286,14083112,2946.5,13710142,0,372970
6684.234627485275,14088931,2909.5,13715804,0,373127
6686.23980140686,14094752,2910.5,13721486,0,373266
6688.247654438019,14100170,2709.0,13726757,0,373413
6690.263238191605,14105853,2841.5,13732279,0,373574
6692.271421670914,14111700,2923.5,13737986,0,373714
6694.2822477817535,14116146,2223.0,13742299,0,373847
6696.2853307724,14120723,2288.5,13746765,0,373958
6698.287949323654,14126187,2732.0,13752087,0,374100
6700.290308237076,14131446,2629.5,13757191,0,374255
6702.300758123398,14136313,2433.5,13761955,0,374358
6704.316325902939,14142056,2871.5,13767554,0,374502
6706.317923545837,14147436,2690.0,13772801,0,374635
6708.324552059174,14152428,2496.0,13777670,0,374758
6710.326562166214,14155753,1662.5,13780909,0,374844
6712.338504314423,14161030,2638.5,13786054,0,374976
6714.343428611755,14166398,2684.0,13791282,0,375116
6716.344829082489,14172402,3002.0,13797145,0,375257
6718.358117580414,14177095,2346.5,13801718,0,375377
6720.3737370967865,14182081,2493.0,13806557,0,375524
6722.376625299454,14187673,2796.0,13812009,0,375664
6724.392199754715,14193031,2679.0,13817226,0,375805
6726.397842168808,14197641,2305.0,13821716,0,375925
6728.4001450538635,14203079,2719.0,13827011,0,376068
6730.41565990448,14208290,2605.5,13832062,0,376228
6732.421295881271,14213492,2601.0,13837129,0,376363
6734.42534327507,14218591,2549.5,13842098,0,376493
6736.433597803116,14224006,2707.5,13847383,0,376623
6738.4463856220245,14229476,2735.0,13852716,0,376760
6740.457595586777,14233447,1985.5,13856578,0,376869
6742.4576160907745,14238323,2438.0,13861319,0,377004
6744.471384048462,14243764,2720.5,13866629,0,377135
6746.471520900726,14249610,2923.0,13872317,0,377293
6748.482347488403,14254511,2450.5,13877113,0,377398
6750.4924211502075,14259732,2610.5,13882201,0,377531
6752.496356010437,14264163,2215.5,13886523,0,377640
6754.49951505661,14268064,1950.5,13890307,0,377757
6756.514123439789,14273196,2566.0,13895291,0,377905
6758.52531003952,14277573,2188.5,13899542,0,378031
6760.526257753372,14282886,2656.5,13904709,0,378177
6762.526737451553,14288615,2864.5,13910272,0,378343
6764.527654886246,14293979,2682.0,13915502,0,378477
6766.5377061367035,14298239,2130.0,13919633,0,378606
6768.554531335831,14303074,2417.5,13924342,0,378732
6770.557590007782,14307061,1993.5,13928227,0,378834
6772.558539390564,14312371,2655.0,13933382,0,378989
6774.565783500671,14317110,2369.5,13937979,0,379131
6776.57733798027,14322126,2508.0,13942843,0,379283
6778.583606481552,14327454,2664.0,13948027,0,379427
6780.599210262299,14332642,2594.0,13953070,0,379572
6782.610525131226,14337731,2544.5,13958045,0,379686
6784.616297483444,14343214,2741.5,13963378,0,379836
6786.617391347885,14349176,2981.0,13969175,0,380001
6788.626769542694,14352551,1687.5,13972482,0,380069
6790.631252288818,14357278,2363.5,13977067,0,380211
6792.632354259491,14362367,2544.5,13982044,0,380323
6794.643122911453,14367960,2796.5,13987488,0,380472
6796.645759344101,14372633,2336.5,13992034,0,380599
6798.661725282669,14377571,2469.0,13996849,0,380722
6800.663284063339,14382252,2340.5,14001406,0,380846
6802.678862810135,14387574,2661.0,14006603,0,380971
6804.683367490768,14392216,2321.0,14011121,0,381095
6806.689386844635,14397535,2659.5,14016305,0,381230
6808.6932916641235,14403074,2769.5,14021712,0,381362
6810.6947066783905,14408494,2710.0,14026965,0,381529
6812.695960283279,14413556,2531.0,14031910,0,381646
6814.706454992294,14417792,2118.0,14036022,0,381770
6816.707439661026,14423308,2758.0,14041392,0,381916
6818.708456039429,14428503,2597.5,14046450,0,382053
6820.719675540924,14433518,2507.5,14051334,0,382184
6822.726104021072,14438453,2467.5,14056142,0,382311
6824.741637229919,14443938,2742.5,14061474,0,382464
6826.744966983795,14449961,3011.5,14067325,0,382636
6828.751495599747,14455678,2858.5,14072888,0,382790
6830.753452062607,14461074,2698.0,14078145,0,382929
6832.762538909912,14465834,2380.0,14082777,0,383057
6834.767692565918,14471492,2829.0,14088285,0,383207
6836.778045654297,14477179,2843.5,14093804,0,383375
6838.781376838684,14482265,2543.0,14098740,0,383525
6840.782464265823,14487693,2714.0,14104016,0,383677
6842.783959150314,14492719,2513.0,14108904,0,383815
6844.788813114166,14497341,2311.0,14113415,0,383926
6846.799495458603,14501722,2190.5,14117676,0,384046
6848.804851770401,14506994,2636.0,14122817,0,384177
6850.804967880249,14511866,2436.0,14127548,0,384318
6852.805722475052,14517624,2879.0,14133138,0,384486
6854.824258565903,14521924,2150.0,14137306,0,384618
6856.831249475479,14527062,2569.0,14142307,0,384755
6858.8410012722015,14532407,2672.5,14147519,0,384888
6860.8551733493805,14537212,2402.5,14152214,0,384998
6862.858289718628,14541940,2364.0,14156819,0,385121
6864.870918512344,14546854,2457.0,14161593,0,385261
6866.875128030777,14551299,2222.5,14165937,0,385362
6868.879892349243,14555087,1894.0,14169626,0,385461
6870.885690689087,14558637,1775.0,14173076,0,385561
6872.897386789322,14563502,2432.5,14177805,0,385697
6874.90139746666,14568280,2389.0,14182468,0,385812
6876.909489870071,14573412,2566.0,14187475,0,385937
6878.924238920212,14577773,2180.5,14191717,0,386056
6880.926031827927,14581828,2027.5,14195671,0,386157
6882.938556909561,14586449,2310.5,14200174,0,386275
6884.9460299015045,14591373,2462.0,14204961,0,386412
6886.955559253693,14596111,2369.0,14209559,0,386552
6888.957676410675,14601983,2936.0,14215273,0,386710
6890.960411787033,14606588,2302.5,14219757,0,386831
6892.96559381485,14611923,2667.5,14224943,0,386980
6894.971290588379,14616255,2166.0,14229154,0,387101
6896.971291303635,14620611,2178.0,14233403,0,387208
6898.985045909882,14626239,2814.0,14238880,0,387359
6900.98711681366,14631424,2592.5,14243928,0,387496
6902.988940000534,14636219,2397.5,14248600,0,387619
6905.004566192627,14641186,2483.5,14253456,0,387730
6907.009876251221,14645760,2287.0,14257931,0,387829
6909.016495466232,14648247,1243.5,14260360,0,387887
6911.016673088074,14652546,2149.5,14264551,0,387995
6913.017512559891,14656310,1882.0,14268213,0,388097
6915.0231120586395,14660979,2334.5,14272754,0,388225
6917.02956533432,14665733,2377.0,14277386,0,388347
6919.030689001083,14670748,2507.5,14282273,0,388475
6921.044156551361,14675440,2346.0,14286829,0,388611
6923.058650016785,14678743,1651.5,14290035,0,388708
6925.061596870422,14683508,2382.5,14294671,0,388837
6927.062624454498,14688274,2383.0,14299291,0,388983
6929.063480615616,14691487,1606.5,14302418,0,389069
6931.069897890091,14696439,2476.0,14307251,0,389188
6933.073259592056,14701767,2664.0,14312422,0,389345
6935.074491024017,14706300,2266.5,14316866,0,389434
6937.082576990128,14710325,2012.5,14320786,0,389539
6939.083570241928,14714069,1872.0,14324432,0,389637
6941.08673620224,14719171,2551.0,14329401,0,389770
6943.092364788055,14724363,2596.0,14334462,0,389901
6945.095564365387,14729009,2323.0,14338987,0,390022
6947.109906435013,14734286,2638.5,14344128,0,390158
6949.124813079834,14739990,2852.0,14349687,0,390303
6951.135407924652,14743800,1905.0,14353393,0,390407
6953.14294552803,14748344,2272.0,14357815,0,390529
6955.147306203842,14752989,2322.5,14362350,0,390639
6957.161869525909,14758344,2677.5,14367568,0,390776
6959.163490056992,14763879,2767.5,14372962,0,390917
6961.165586233139,14769258,2689.5,14378224,0,391034
6963.179221868515,14775083,2912.5,14383898,0,391185
6965.184052705765,14780344,2630.5,14389015,0,391329
6967.1849093437195,14785262,2459.0,14393800,0,391462
6969.194181919098,14790344,2541.0,14398750,0,391594
6971.197203874588,14795588,2622.0,14403845,0,391743
6973.212563037872,14801425,2918.5,14409531,0,391894
6975.212832450867,14805648,2111.5,14413643,0,392005
6977.213578224182,14810670,2511.0,14418526,0,392144
6979.2222237586975,14815927,2628.5,14423642,0,392285
6981.227157354355,14821158,2615.5,14428739,0,392419
6983.230718612671,14826269,2555.5,14433706,0,392563
6985.232634544373,14831241,2486.0,14438558,0,392683
6987.232976675034,14836490,2624.5,14443668,0,392822
6989.236355066299,14841848,2679.0,14448878,0,392970
6991.239188194275,14846458,2305.0,14453356,0,393102
6993.246782302856,14850917,2229.5,14457713,0,393204
6995.250139713287,14854769,1926.0,14461460,0,393309
6997.250359296799,14860139,2685.0,14466689,0,393450
6999.255344629288,14864643,2252.0,14471082,0,393561
7001.255788564682,14869660,2508.5,14475973,0,393687
7003.259796380997,14874235,2287.5,14480421,0,393814
7005.261341810226,14877526,1645.5,14483620,0,393906
7007.2710700035095,14882338,2406.0,14488319,0,394019
7009.271524190903,14886876,2269.0,14492722,0,394154
7011.273974895477,14890228,1676.0,14495999,0,394229
7013.2766880989075,14894087,1929.5,14499747,0,394340
7015.277273416519,14898849,2381.0,14504378,0,394471
7017.2795243263245,14903639,2395.0,14509063,0,394576
7019.287646055222,14908750,2555.5,14514044,0,394706
7021.301576137543,14913507,2378.5,14518669,0,394838
7023.305994987488,14916577,1535.0,14521665,0,394912
7025.3069496154785,14920533,1978.0,14525514,0,395019
7027.3159375190735,14925156,2311.5,14530007,0,395149
7029.324331283569,14929985,2414.5,14534722,0,395263
7031.338541984558,14935010,2512.5,14539619,0,395391
7033.3501563072205,14940463,2726.5,14544913,0,395550
7035.365013360977,14945272,2404.5,14549580,0,395692
7037.365369319916,14950207,2467.5,14554387,0,395820
7039.38112449646,14955225,2509.0,14559267,0,395958
7041.3833973407745,14960444,2609.5,14564352,0,396092
7043.386115550995,14965442,2499.0,14569218,0,396224
7045.401112794876,14970986,2772.0,14574626,0,396360
7047.401909828186,14976635,2824.5,14580110,0,396525
7049.409925222397,14982212,2788.5,14585548,0,396664
7051.424918174744,14987088,2438.0,14590302,0,396786
7053.426702976227,14992090,2501.0,14595174,0,396916
7055.437242746353,14996803,2356.5,14599753,0,397050
7057.449146270752,14999730,1463.5,14602605,0,397125
7059.455558300018,15003714,1992.0,14606483,0,397231
7061.460565805435,15008940,2613.0,14611577,0,397363
7063.4645652771,15015005,3032.5,14617494,0,397511
7065.465906381607,15020974,2984.5,14623324,0,397650
7067.46701002121,15026874,2950.0,14629073,0,397801
7069.4676122665405,15032512,2819.0,14634546,0,397966
7071.469232082367,15038400,2944.0,14640299,0,398101
7073.478111982346,15044136,2868.0,14645892,0,398244
7075.479735851288,15049561,2712.5,14651153,0,398408
7077.480922937393,15055055,2747.0,14656492,0,398563
7079.482357501984,15060577,2761.0,14661856,0,398721
7081.482502937317,15066501,2962.0,14667605,0,398896
7083.4865629673,15071472,2485.5,14672449,0,399023
7085.501437425613,15076568,2548.0,14677417,0,399151
7087.506360530853,15082445,2938.5,14683140,0,399305
7089.520523071289,15087317,2436.0,14687886,0,399431
7091.5317466259,15092001,2342.0,14692436,0,399565
7093.533642292023,15097028,2513.5,14697349,0,399679
7095.538793802261,15102112,2542.0,14702301,0,399811
7097.540309906006,15106445,2166.5,14706524,0,399921
7099.543739557266,15111197,2376.0,14711145,0,400052
7101.551243543625,15116151,2477.0,14715963,0,400188
7103.554881095886,15121256,2552.5,14720948,0,400308
7105.5608122348785,15126035,2389.5,14725597,0,400438
7107.57621383667,15130516,2240.5,14729953,0,400563
7109.582877159119,15135583,2533.5,14734883,0,400700
7111.583869934082,15141377,2897.0,14740526,0,400851
7113.58593249321,15146471,2547.0,14745496,0,400975
7115.5941479206085,15149464,1496.5,14748428,0,401036
7117.59486246109,15154622,2579.0,14753442,0,401180
7119.597942352295,15160074,2726.0,14758755,0,401319
7121.599462985992,15165583,2754.5,14764143,0,401440
7123.6102206707,15170188,2302.5,14768642,0,401546
7125.624567747116,15175205,2508.5,14773519,0,401686
7127.6297652721405,15180671,2733.0,14778851,0,401820
7129.644893407822,15185674,2501.5,14783708,0,401966
7131.660499572754,15191002,2664.0,14788911,0,402091
7133.661891937256,15196561,2779.5,14794345,0,402216
7135.672323942184,15201871,2655.0,14799519,0,402352
7137.683682441711,15207662,2895.5,14805162,0,402500
7139.693132400513,15212698,2518.0,14810070,0,402628
7141.709202528,15217826,2564.0,14815059,0,402767
7143.723103761673,15223361,2767.5,14820460,0,402901
7145.724801063538,15228326,2482.5,14825298,0,403028
7147.7401287555695,15233347,2510.5,14830178,0,403169
7149.750233888626,15238595,2624.0,14835292,0,403303
7151.755122661591,15244578,2991.5,14841099,0,403479
7153.761403560638,15250371,2896.5,14846725,0,403646
7155.767757177353,15256231,2930.0,14852414,0,403817
7157.773606061935,15261274,2521.5,14857333,0,403941
7159.7743191719055,15266335,2530.5,14862256,0,404079
7161.775527238846,15271621,2643.0,14867403,0,404218
7163.783433675766,15276311,2345.0,14871970,0,404341
7165.797365188599,15281548,2618.5,14877037,0,404511
7167.7992062568665,15287414,2933.0,14882732,0,404682
7169.812361240387,15293120,2853.0,14888274,0,404846
7171.81756734848,15298277,2578.5,14893298,0,404979
7173.81992316246,15303569,2646.0,14898448,0,405121
7175.8326370716095,15308246,2338.5,14902997,0,405249
7177.83483338356,15313406,2580.0,14908031,0,405375
7179.846348762512,15317957,2275.5,14912463,0,405494
7181.847367286682,15322971,2507.0,14917341,0,405630
7183.854481935501,15327719,2374.0,14921966,0,405753
7185.858830451965,15332684,2482.5,14926783,0,405901
7187.8687109947205,15336835,2075.5,14930835,0,406000
7189.8725616931915,15340966,2065.5,14934857,0,406109
7191.88396525383,15345996,2515.0,14939754,0,406242
7193.897673368454,15351734,2869.0,14945317,0,406417
7195.9116377830505,15355946,2106.0,14949432,0,406514
7197.920852184296,15361201,2627.5,14954550,0,406651
7199.928551912308,15366207,2503.0,14959421,0,406786
7201.933799505234,15370688,2240.5,14963794,0,406894
7203.934967279434,15374831,2071.5,14967816,0,407015
7205.9482226371765,15379605,2387.0,14972458,0,407147
7207.960148334503,15385067,2731.0,14977773,0,407294
7209.96844959259,15390228,2580.5,14982814,0,407414
7211.97651720047,15394445,2108.5,14986926,0,407519
7213.982166290283,15399862,2708.5,14992203,0,407659
7215.9835703372955,15405423,2780.5,14997612,0,407811
7217.989834308624,15409196,1886.5,15001301,0,407895
7219.99053144455,15413078,1941.0,15005092,0,407986
7221.994281768799,15418392,2657.0,15010251,0,408141
7224.006982088089,15423833,2720.5,15015576,0,408257
7226.013416528702,15428417,2292.0,15020048,0,408369
7228.018209218979,15433387,2485.0,15024865,0,408522
7230.019441604614,15438567,2590.0,15029905,0,408662
7232.0343198776245,15442550,1991.5,15033795,0,408755
7234.037665605545,15447400,2425.0,15038525,0,408875
7236.0454387664795,15452721,2660.5,15043716,0,409005
7238.045575380325,15457851,2565.0,15048722,0,409129
7240.05730843544,15462918,2533.5,15053676,0,409242
7242.058705568314,15468058,2570.0,15058674,0,409384
7244.059895515442,15472992,2467.0,15063467,0,409525
7246.063858032227,15478748,2878.0,15069079,0,409669
7248.075482606888,15482875,2063.5,15073095,0,409780
7250.084152460098,15487660,2392.5,15077753,0,409907
7252.097783565521,15492820,2580.0,15082783,0,410037
7254.101335287094,15496882,2031.0,15086746,0,410136
7256.110360383987,15501520,2319.0,15091233,0,410287
7258.117801904678,15504737,1608.5,15094371,0,410366
7260.130890369415,15509514,2388.5,15099014,0,410500
7262.135642528534,15514408,2447.0,15103775,0,410633
7264.137913227081,15518208,1900.0,15107472,0,410736
7266.150780439377,15522141,1966.5,15111302,0,410839
7268.152111053467,15526933,2396.0,15115982,0,410951
7270.1533036231995,15531102,2084.5,15120053,0,411049
7272.165090084076,15536192,2545.0,15124997,0,411195
7274.166186094284,15541491,2649.5,15130151,0,411340
7276.170697212219,15546704,2606.5,15135241,0,411463
7278.178546905518,15552481,2888.5,15140857,0,411624
7280.182242870331,15557715,2617.0,15145956,0,411759
7282.185174703598,15562828,2556.5,15150933,0,411895
7284.193798303604,15567027,2099.5,15155021,0,412006
7286.195202827454,15570284,1628.5,15158201,0,412083
7288.197834014893,15574671,2193.5,15162471,0,412200
7290.2133202552795,15577953,1641.0,15165668,0,412285
7292.22537446022,15582315,2181.0,15169929,0,412386
7294.232000827789,15586904,2294.5,15174400,0,412504
7296.249170780182,15592222,2659.0,15179572,0,412650
7298.24961400032,15598237,3007.5,15185418,0,412819
7300.255043745041,15602636,2199.5,15189707,0,412929
7302.2684490680695,15607936,2650.0,15194868,0,413068
7304.283983230591,15613931,2997.5,15200690,0,413241
7306.286506652832,15620099,3084.0,15206698,0,413401
7308.291729927063,15624739,2320.0,15211210,0,413529
7310.292541503906,15630567,2914.0,15216885,0,413682
7312.299055099487,15636042,2737.5,15222205,0,413837
7314.304132223129,15641974,2966.0,15228000,0,413974
7316.304780006409,15647810,2918.0,15233674,0,414136
7318.306087970734,15652092,2141.0,15237851,0,414241
7320.310545921326,15657626,2767.0,15243251,0,414375
7322.311612129211,15663409,2891.5,15248890,0,414519
7324.312138795853,15669420,3005.5,15254717,0,414703
7326.326755523682,15674665,2622.5,15259804,0,414861
7328.329282283783,15679717,2526.0,15264741,0,414976
7330.329442024231,15683604,1943.5,15268534,0,415070
7332.330085039139,15688447,2421.5,15273257,0,415190
7334.346244812012,15693181,2367.0,15277875,0,415306
7336.348070859909,15699431,3125.0,15283943,0,415488
7338.357435703278,15705649,3109.0,15289982,0,415667
7340.362866640091,15711711,3031.0,15295921,0,415790
7342.363012313843,15717229,2759.0,15301291,0,415938
7344.36695933342,15722835,2803.0,15306742,0,416093
7346.366982936859,15728812,2988.5,15312585,0,416227
7348.373079776764,15734665,2926.5,15318271,0,416394
7350.388597488403,15740963,3149.0,15324408,0,416555
7352.395477771759,15747189,3113.0,15330475,0,416714
7354.395498991013,15752769,2790.0,15335892,0,416877
7356.409387588501,15758331,2781.0,15341286,0,417045
7358.409834623337,15764396,3032.5,15347180,0,417216
7360.412420272827,15770493,3048.5,15353105,0,417388
7362.4140729904175,15776301,2904.0,15358763,0,417538
7364.415523529053,15781721,2710.0,15364061,0,417660
7366.4175617694855,15787837,3058.0,15370017,0,417820
7368.433187961578,15793772,2967.5,15375799,0,417973
7370.434233427048,15799885,3056.5,15381755,0,418130
7372.435129880905,15805913,3014.0,15387632,0,418281
7374.435913324356,15811923,3005.0,15393479,0,418444
7376.437148571014,15817921,2999.0,15399313,0,418608
7378.441395521164,15823828,2953.5,15405051,0,418777
7380.441935300827,15829668,2920.0,15410758,0,418910
7382.447425127029,15835786,3059.0,15416722,0,419064
7384.460600852966,15840976,2595.0,15421780,0,419196
7386.461183786392,15846919,2971.5,15427544,0,419375
7388.461185693741,15852801,2941.0,15433275,0,419526
7390.471296310425,15858662,2930.5,15438997,0,419665
7392.472347974777,15863428,2383.0,15443652,0,419776
7394.476379156113,15868851,2711.5,15448935,0,419916
7396.477395057678,15874832,2990.5,15454763,0,420069
7398.487602472305,15878952,2060.0,15458781,0,420171
7400.502912759781,15884583,2815.5,15464269,0,420314
7402.504581451416,15890846,3131.5,15470373,0,420473
7404.506084918976,15896968,3061.0,15476330,0,420638
7406.517690420151,15901316,2174.0,15480567,0,420749
7408.519490718842,15906794,2739.0,15485891,0,420903
7410.519490718842,15912986,3096.0,15491923,0,421063
7412.520231246948,15918976,2995.0,15497786,0,421190
7414.52294588089,15924836,2930.0,15503497,0,421339
7416.52503657341,15930811,2987.5,15509329,0,421482
7418.525134563446,15936860,3024.5,15515217,0,421643
7420.541023731232,15942129,2634.5,15520363,0,421766
7422.543214797974,15948324,3097.5,15526396,0,421928
7424.54409122467,15954370,3023.0,15532268,0,422102
7426.544979572296,15960517,3073.5,15538244,0,422273
7428.545290231705,15966545,3014.0,15544118,0,422427
7430.547082185745,15972464,2959.5,15549884,0,422580
7432.547452688217,15978518,3027.0,15555780,0,422738
7434.55437707901,15982575,2028.5,15559736,0,422839
7436.555349349976,15988198,2811.5,15565191,0,423007
7438.5632791519165,15994062,2932.0,15570909,0,423153
7440.565870285034,15999089,2513.5,15575776,0,423313
7442.581485033035,16005111,3011.0,15581626,0,423485
7444.581497907639,16011171,3030.0,15587531,0,423640
7446.586352348328,16016505,2667.0,15592721,0,423784
7448.58762717247,16022373,2934.0,15598435,0,423938
7450.600629091263,16028152,2889.5,15604072,0,424080
7452.60843038559,16033911,2879.5,15609675,0,424236
7454.609623193741,16039853,2971.0,15615472,0,424381
7456.610609531403,16044090,2118.5,15619600,0,424490
7458.6114637851715,16049996,2953.0,15625350,0,424646
7460.613204956055,16056080,3042.0,15631280,0,424800
7462.614084482193,16061757,2838.5,15636801,0,424956
7464.622501134872,16067839,3041.0,15642722,0,425117
7466.633418798447,16073932,3046.5,15648656,0,425276
7468.640188217163,16079773,2920.5,15654347,0,425426
7470.644216299057,16085838,3032.5,15660252,0,425586
7472.656802654266,16090793,2477.5,15665095,0,425698
7474.664230108261,16096577,2892.0,15670741,0,425836
7476.664993524551,16102747,3085.0,15676753,0,425994
7478.66640162468,16108784,3018.5,15682629,0,426155
7480.670572757721,16114754,2985.0,15688417,0,426337
7482.672545909882,16119089,2167.5,15692646,0,426443
7484.672546625137,16125005,2958.0,15698410,0,426595
7486.673484802246,16131060,3027.5,15704290,0,426770
7488.675990581512,16136988,2964.0,15710062,0,426926
7490.676659107208,16143125,3068.5,15716053,0,427072
7492.676659822464,16149391,3133.0,15722177,0,427214
7494.684815406799,16155531,3070.0,15728158,0,427373
7496.691479444504,16161630,3049.5,15734092,0,427538
7498.694434165955,16167812,3091.0,15740127,0,427685
7500.695188045502,16174105,3146.5,15746222,0,427883
7502.704040527344,16180100,2997.5,15752054,0,428046
7504.718174934387,16186050,2975.0,15757837,0,428213
7506.720111370087,16191584,2767.0,15763229,0,428355
7508.7201359272,16197708,3062.0,15769193,0,428515
7510.733331680298,16203754,3023.0,15775066,0,428688
7512.734060049057,16209911,3078.5,15781067,0,428844
7514.7420082092285,16216186,3137.5,15787206,0,428980
7516.757616519928,16222256,3035.0,15793105,0,429151
7518.758046865463,16228201,2972.5,15798897,0,429304
7520.7658360004425,16233873,2836.0,15804443,0,429430
7522.769547462463,16239772,2949.5,15810179,0,429593
7524.7712569236755,16245923,3075.5,15816155,0,429768
7526.782701969147,16251740,2908.5,15821826,0,429914
7528.784172296524,16257876,3068.0,15827789,0,430087
7530.785110235214,16263027,2575.5,15832811,0,430216
7532.787085056305,16269048,3010.5,15838670,0,430378
7534.796936273575,16274646,2799.0,15844109,0,430537
7536.802214860916,16280772,3063.0,15850089,0,430683
7538.802216053009,16286840,3034.0,15855987,0,430853
7540.802670478821,16292522,2841.0,15861510,0,431012
7542.8183081150055,16298035,2756.5,15866878,0,431157
7544.818759679794,16304230,3097.5,15872920,0,431310
7546.820901632309,16310286,3028.0,15878820,0,431466
7548.825026512146,16316406,3060.0,15884758,0,431648
7550.828037023544,16322131,2862.5,15890340,0,431791
7552.8301384449005,16328239,3054.0,15896269,0,431970
7554.830138683319,16334365,3063.0,15902222,0,432143
7556.840086698532,16340303,2969.0,15908017,0,432286
7558.854877948761,16346108,2902.5,15913658,0,432450
7560.85662484169,16351916,2904.0,15919306,0,432610
7562.872252225876,16358180,3132.0,15925405,0,432775
7564.873343229294,16364357,3088.5,15931393,0,432964
7566.88893032074,16370517,3080.0,15937383,0,433134
7568.897290468216,16376637,3060.0,15943348,0,433289
7570.898237943649,16382830,3096.5,15949376,0,433454
7572.899119853973,16389094,3132.0,15955458,0,433636
7574.9027507305145,16395029,2967.5,15961230,0,433799
7576.91092467308,16400798,2884.5,15966861,0,433937
7578.9151475429535,16406294,2748.0,15972206,0,434088
7580.918931245804,16412175,2940.5,15977923,0,434252
7582.923229455948,16418213,3019.0,15983796,0,434417
7584.92905831337,16423684,2735.5,15989125,0,434559
7586.931299209595,16429823,3069.5,15995085,0,434738
7588.944914340973,16435641,2909.0,16000737,0,434904
7590.950708627701,16441313,2836.0,16006257,0,435056
7592.9653697013855,16447223,2955.0,16012021,0,435202
7594.973823785782,16452842,2809.5,16017481,0,435361
7596.989445924759,16458986,3072.0,16023453,0,435533
7598.9894461631775,16465069,3041.5,16029384,0,435685
7600.991930246353,16470484,2707.5,16034645,0,435839
7602.993417739868,16476567,3041.5,16040572,0,435995
7604.994842529297,16482429,2931.0,16046273,0,436156
7606.9974863529205,16488532,3051.5,16052230,0,436302
7608.999579191208,16494661,3064.5,16058202,0,436459
7611.0020315647125,16500367,2853.0,16063745,0,436622
7613.010078191757,16506478,3055.5,16069693,0,436785
7615.01007938385,16512650,3086.0,16075718,0,436932
7617.015077352524,16518754,3052.0,16081660,0,437094
7619.015971183777,16524571,2908.5,16087328,0,437243
7621.0169842243195,16530409,2919.0,16093009,0,437400
7623.027893781662,16535564,2577.5,16098026,0,437538
7625.039308786392,16540855,2645.5,16103169,0,437686
7627.040051460266,16546373,2759.0,16108537,0,437836
7629.041777610779,16552389,3008.0,16114421,0,437968
7631.048141717911,16558364,2987.5,16120241,0,438123
7633.0562562942505,16564515,3075.5,16126250,0,438265
7635.0710780620575,16570562,3023.5,16132149,0,438413
7637.072057008743,16576750,3094.0,16138182,0,438568
7639.07960319519,16582837,3043.5,16144114,0,438723
7641.08477640152,16588934,3048.5,16150069,0,438865
7643.087279319763,16594826,2946.0,16155808,0,439018
7645.099308252335,16600449,2811.5,16161263,0,439186
7647.110151052475,16606208,2879.5,16166890,0,439318
7649.121952295303,16612155,2973.5,16172677,0,439478
7651.134271860123,16618250,3047.5,16178589,0,439661
7653.146456956863,16624104,2927.0,16184276,0,439828
7655.158272743225,16629884,2890.0,16189900,0,439984
7657.169791460037,16636172,3144.0,16196029,0,440143
7659.1803658008575,16640527,2177.5,16200281,0,440246
7661.195032835007,16644264,1868.5,16203919,0,440345
7663.2055678367615,16650460,3098.0,16209934,0,440526
7665.219899177551,16656743,3141.5,16216060,0,440683
7667.229717254639,16662912,3084.5,16222052,0,440860
7669.230833053589,16668908,2998.0,16227904,0,441004
7671.242592573166,16675127,3109.5,16233953,0,441174
7673.254071712494,16681391,3132.0,16240035,0,441356
7675.266521453857,16687489,3049.0,16245970,0,441519
7677.268056869507,16693410,2960.5,16251723,0,441687
7679.280469894409,16699469,3029.5,16257625,0,441844
7681.290004730225,16705485,3008.0,16263482,0,442003
7683.301656961441,16711637,3076.0,16269465,0,442172
7685.312471151352,16717895,3129.0,16275564,0,442331
7687.315217256546,16724071,3088.0,16281567,0,442504
7689.326756000519,16730241,3085.0,16287568,0,442673
7691.327978849411,16736326,3042.5,16293489,0,442837
7693.339832305908,16742545,3109.5,16299538,0,443007
7695.35055398941,16748835,3145.0,16305653,0,443182
7697.362355232239,16755116,3140.5,16311763,0,443353
7699.374142885208,16760966,2925.0,16317473,0,443493
7701.386978626251,16767208,3121.0,16323544,0,443664
7703.398998498917,16773546,3169.0,16329705,0,443841
7705.411818981171,16779799,3126.5,16335786,0,444013
7707.42266869545,16785976,3088.5,16341799,0,444177
7709.437125921249,16792102,3063.0,16347751,0,444351
7711.448385953903,16798281,3089.5,16353775,0,444506
7713.459104061127,16804606,3162.5,16359924,0,444682
7715.4713616371155,16810247,2820.5,16365408,0,444839
7717.483433008194,16816283,3018.0,16371293,0,444990
7719.495279788971,16822389,3053.0,16377237,0,445152
7721.509592056274,16828557,3084.0,16383266,0,445291
7723.524500608444,16834641,3042.0,16389179,0,445462
7725.537688493729,16840788,3073.5,16395163,0,445625
7727.5515213012695,16846963,3087.5,16401174,0,445789
7729.564465761185,16853210,3123.5,16407253,0,445957
7731.5691776275635,16859163,2976.5,16413058,0,446105
7733.580179691315,16865356,3096.5,16419081,0,446275
7735.592024803162,16871583,3113.5,16425144,0,446439
7737.603836297989,16877771,3094.0,16431182,0,446589
7739.615283250809,16883961,3095.0,16437208,0,446753
7741.616300582886,16889955,2997.0,16443057,0,446898
7743.625994920731,16896137,3091.0,16449058,0,447079
7745.637638807297,16902328,3095.5,16455096,0,447232
7747.6500453948975,16908405,3038.5,16461004,0,447401
7749.66127038002,16914626,3110.5,16467053,0,447573
7751.67342877388,16920902,3138.0,16473150,0,447752
7753.684933185577,16927160,3129.0,16479255,0,447905
7755.697238683701,16933457,3148.5,16485361,0,448096
7757.70778632164,16939527,3035.0,16491282,0,448245
7759.719513654709,16945513,2993.0,16497119,0,448394
7761.729958295822,16951801,3144.0,16503249,0,448552
7763.731550216675,16957939,3069.0,16509226,0,448713
7765.746402978897,16964120,3090.5,16515241,0,448879
7767.7490670681,16970145,3012.5,16521110,0,449035
7769.7638902664185,16976386,3120.5,16527209,0,449177
7771.774639606476,16982640,3127.0,16533287,0,449353
7773.780504703522,16988733,3046.5,16539216,0,449517
7775.793829679489,16994477,2872.0,16544801,0,449676
7777.805278301239,17000581,3052.0,16550751,0,449830
7779.817978620529,17006910,3164.5,16556899,0,450011
7781.831059455872,17013007,3048.5,16562841,0,450166
7783.841584205627,17019176,3084.5,16568850,0,450326
7785.85005736351,17025449,3136.5,16574974,0,450475
7787.860575437546,17031756,3153.5,16581114,0,450642
7789.871046304703,17036028,2136.0,16585288,0,450740
7791.8840181827545,17041510,2741.0,16590608,0,450902
7793.895060539246,17047788,3139.0,16596731,0,451057
7795.905481815338,17054067,3139.5,16602843,0,451224
7797.918057203293,17059574,2753.5,16608194,0,451380
7799.929279327393,17064415,2420.5,16612920,0,451495
7801.931946516037,17070531,3058.0,16618863,0,451668
7803.94701218605,17076746,3107.5,16624911,0,451835
7805.959245920181,17082948,3101.0,16630954,0,451994
7807.96399474144,17088900,2976.0,16636752,0,452148
7809.9731023311615,17094997,3048.5,16642688,0,452309
7811.982714653015,17101021,3012.0,16648542,0,452479
7813.998340845108,17107204,3091.5,16654564,0,452640
7816.007368087769,17113432,3114.0,16660634,0,452798
7818.007369995117,17119451,3009.5,16666476,0,452975
7820.008331298828,17125526,3037.5,16672401,0,453125
7822.0102598667145,17131739,3106.5,16678462,0,453277
7824.011363267899,17137729,2995.0,16684294,0,453435
7826.018585443497,17143815,3043.0,16690212,0,453603
7828.024470329285,17149972,3078.5,16696208,0,453764
7830.026127815247,17156258,3143.0,16702321,0,453937
7832.027016401291,17162426,3084.0,16708337,0,454089
7834.034070014954,17168263,2918.5,16714014,0,454249
7836.038182973862,17173925,2831.0,16719528,0,454397
7838.038743972778,17179808,2941.5,16725265,0,454543
7840.0392372608185,17184609,2400.5,16729932,0,454677
7842.041363954544,17190762,3076.5,16735910,0,454852
7844.043037891388,17196818,3028.0,16741810,0,455008
7846.044500589371,17203015,3098.5,16747861,0,455154
7848.047109603882,17209277,3131.0,16753954,0,455323
7850.047246456146,17213735,2229.0,16758284,0,455451
7852.061003923416,17219423,2844.0,16763829,0,455594
7854.06113576889,17225568,3072.5,16769818,0,455750
7856.061660051346,17231777,3104.5,16775849,0,455928
7858.061681032181,17237911,3067.0,16781809,0,456102
7860.062442302704,17243968,3028.5,16787713,0,456255
7862.064465522766,17250158,3095.0,16793728,0,456430
7864.065398693085,17256569,3205.5,16799970,0,456599
7866.065587043762,17262576,3003.5,16805827,0,456749
7868.073256015778,17268347,2885.5,16811453,0,456894
7870.073771238327,17274337,2995.0,16817295,0,457042
7872.078499555588,17279955,2809.0,16822774,0,457181
7874.093711137772,17286017,3031.0,16828675,0,457342
7876.093711137772,17292245,3114.0,16834713,0,457532
7878.108240365982,17298624,3189.5,16840917,0,457707
7880.120436429977,17304536,2956.0,16846676,0,457860
7882.125250339508,17310620,3042.0,16852609,0,458011
7884.133430242538,17316909,3144.5,16858734,0,458175
7886.133452653885,17323061,3076.0,16864734,0,458327
7888.135637760162,17329128,3033.5,16870641,0,458487
7890.149646759033,17335384,3128.0,16876730,0,458654
7892.1517922878265,17341588,3102.0,16882758,0,458830
7894.15372300148,17347295,2853.5,16888330,0,458965
7896.1551768779755,17353281,2993.0,16894171,0,459110
7898.169075965881,17359540,3129.5,16900261,0,459279
7900.170058488846,17365765,3112.5,16906317,0,459448
7902.170058727264,17371863,3049.0,16912257,0,459606
7904.183196783066,17378002,3069.5,16918221,0,459781
7906.183219909668,17384109,3053.5,16924170,0,459939
7908.183680295944,17390389,3140.0,16930286,0,460103
7910.192792415619,17396648,3129.5,16936392,0,460256
7912.197866201401,17402725,3038.5,16942316,0,460409
7914.209696531296,17408873,3074.0,16948323,0,460550
7916.210783481598,17414872,2999.5,16954163,0,460709
7918.212318181992,17421007,3067.5,16960125,0,460882
7920.2279324531555,17426822,2907.5,16965783,0,461039
7922.227957487106,17432713,2945.5,16971510,0,461203
7924.230520963669,17438332,2809.5,16976972,0,461360
7926.231520414352,17444213,2940.5,16982693,0,461520
7928.247025489807,17449922,2854.5,16988249,0,461673
7930.247744321823,17455534,2806.0,16993723,0,461811
7932.247744560242,17461756,3111.0,16999788,0,461968
7934.247745513916,17465809,2026.5,17003743,0,462066
7936.263395547867,17471931,3061.0,17009693,0,462238
7938.264837265015,17478139,3104.0,17015734,0,462405
7940.265779018402,17484386,3123.5,17021818,0,462568
7942.265785455704,17490520,3067.0,17027816,0,462704
7944.276274442673,17496368,2924.0,17033514,0,462854
7946.27700138092,17502478,3055.0,17039475,0,463003
7948.277629613876,17508801,3161.5,17045641,0,463160
7950.285418987274,17515049,3124.0,17051720,0,463329
7952.287608623505,17521020,2985.5,17057554,0,463466
7954.291038513184,17526766,2873.0,17063147,0,463619
7956.292416572571,17532918,3076.0,17069151,0,463767
7958.29359459877,17539182,3132.0,17075258,0,463924
7960.298542737961,17545211,3014.5,17081131,0,464080
7962.312872409821,17549782,2285.5,17085583,0,464199
7964.328388214111,17554821,2519.5,17090486,0,464335
7966.328987121582,17561110,3144.5,17096634,0,464476
7968.329008102417,17567189,3039.5,17102556,0,464633
7970.341960430145,17572412,2611.5,17107632,0,464780
7972.357583761215,17576324,1956.0,17111439,0,464885
7974.35758638382,17582278,2977.0,17117231,0,465047
7976.373208284378,17588296,3009.0,17123098,0,465198
7978.373313903809,17593914,2809.0,17128557,0,465357
7980.385217428207,17599987,3036.5,17134476,0,465511
7982.400857925415,17603627,1820.0,17137997,0,465630
7984.401931762695,17609075,2724.0,17143316,0,465759
7986.403567790985,17615164,3044.5,17149240,0,465924
7988.410140991211,17621169,3002.5,17155084,0,466085
7990.41038608551,17627301,3066.0,17161068,0,466233
7992.412407398224,17633239,2969.0,17166868,0,466371
7994.413081407547,17639450,3105.5,17172930,0,466520
7996.418162584305,17645786,3168.0,17179121,0,466665
7998.419763088226,17651171,2692.5,17184378,0,466793
8000.435272693634,17655139,1984.0,17188246,0,466893
8002.450884103775,17658910,1885.5,17191909,0,467001
8004.453647136688,17663593,2341.5,17196480,0,467113
8006.45730805397,17669370,2888.5,17202086,0,467284
8008.457936048508,17675462,3046.0,17207997,0,467465
8010.468568325043,17681689,3113.5,17214046,0,467643
8012.469082832336,17688006,3158.5,17220154,0,467852
8014.483105897903,17693793,2893.5,17225778,0,468015
8016.493772268295,17699675,2941.0,17231513,0,468162
8018.497589111328,17705908,3116.5,17237588,0,468320
8020.497954368591,17710844,2468.0,17242392,0,468452
8022.5135724544525,17714061,1608.5,17245533,0,468528
8024.519982814789,17720175,3057.0,17251499,0,468676
8026.521991491318,17724181,2003.0,17255388,0,468793
8028.523980617523,17729406,2612.5,17260476,0,468930
8030.526747226715,17735678,3136.0,17266588,0,469090
8032.532172679901,17741791,3056.5,17272536,0,469255
8034.542716741562,17748014,3111.5,17278591,0,469423
8036.548081636429,17754312,3149.0,17284712,0,469600
8038.563683748245,17760534,3111.0,17290778,0,469756
8040.56662940979,17766613,3039.5,17296717,0,469896
8042.576021194458,17772852,3119.5,17302788,0,470064
8044.576026678085,17779016,3082.0,17308780,0,470236
8046.589614152908,17785312,3148.0,17314895,0,470417
8048.592873811722,17791417,3052.5,17320867,0,470550
8050.597143173218,17797413,2998.0,17326695,0,470718
8052.6057188510895,17803668,3127.5,17332797,0,470871
8054.607483625412,17809969,3150.5,17338959,0,471010
8056.608322143555,17816175,3103.0,17344998,0,471177
8058.621315479279,17822138,2981.5,17350814,0,471324
8060.621336936951,17828168,3015.0,17356685,0,471483
8062.622583866119,17834412,3122.0,17362756,0,471656
8064.624514341354,17840164,2876.0,17368362,0,471802
8066.624514341354,17845843,2839.5,17373896,0,471947
8068.63317656517,17852124,3140.5,17380000,0,472124
8070.634787559509,17858540,3208.0,17386250,0,472290
8072.644444227219,17864574,3017.0,17392103,0,472471
8074.655129909515,17870345,2885.5,17397715,0,472630
8076.655130147934,17876608,3131.5,17403819,0,472789
8078.660511016846,17882833,3112.5,17409887,0,472946
8080.671860218048,17888852,3009.5,17415758,0,473094
8082.672745466232,17895000,3074.0,17421737,0,473263
8084.673604488373,17900250,2625.0,17426840,0,473410
8086.673605680466,17905893,2821.5,17432341,0,473552
8088.673985242844,17911241,2674.0,17437549,0,473692
8090.689590930939,17916990,2874.5,17443122,0,473868
8092.692272901535,17923208,3109.0,17449160,0,474048
8094.707897424698,17929135,2963.5,17454916,0,474219
8096.717888116837,17934857,2861.0,17460497,0,474360
8098.729301452637,17940993,3068.0,17466478,0,474515
8100.744946479797,17947040,3023.5,17472372,0,474668
8102.745032548904,17952952,2956.0,17478141,0,474811
8104.760548830032,17959053,3050.5,17484077,0,474976
8106.761064291,17965224,3085.5,17490098,0,475126
8108.761974334717,17971475,3125.5,17496180,0,475295
8110.767242670059,17977515,3020.0,17502076,0,475439
8112.767541408539,17983576,3030.5,17507972,0,475604
8114.76895570755,17987483,1953.5,17511773,0,475710
8116.775724887848,17993506,3011.5,17517621,0,475885
8118.777062654495,17999553,3023.5,17523510,0,476043
8120.7848072052,18005683,3065.0,17529487,0,476196
8122.785413265228,18011873,3095.0,17535503,0,476370
8124.7859172821045,18018144,3135.5,17541600,0,476544
8126.801369428635,18023381,2618.5,17546711,0,476670
8128.80137014389,18029426,3022.5,17552594,0,476832
8130.813710689545,18035336,2955.0,17558343,0,476993
8132.814264535904,18039031,1847.5,17561950,0,477081
8134.816065073013,18043768,2368.5,17566560,0,477208
8136.817041158676,18048790,2511.0,17571432,0,477358
8138.817041397095,18054191,2700.5,17576698,0,477493
8140.81773018837,18060326,3067.5,17582679,0,477647
8142.817758321762,18066399,3036.5,17588598,0,477801
8144.833362817764,18071944,2772.5,17593998,0,477946
8146.8489809036255,18077435,2745.5,17599347,0,478088
8148.861708641052,18083634,3099.5,17605405,0,478229
8150.86750459671,18088697,2531.5,17610344,0,478353
8152.875368356705,18094567,2935.0,17616057,0,478510
8154.875402927399,18100307,2870.0,17621659,0,478648
8156.8764588832855,18106293,2993.0,17627475,0,478818
8158.8775000572205,18112125,2916.0,17633148,0,478977
8160.888636112213,18118160,3017.5,17639047,0,479113
8162.899591445923,18124477,3158.5,17645202,0,479275
8164.900485038757,18130239,2881.0,17650833,0,479406
8166.909471750259,18135350,2555.5,17655838,0,479512
8168.923305749893,18141426,3038.0,17661752,0,479674
8170.924716711044,18147591,3082.5,17667734,0,479857
8172.940319299698,18153603,3006.0,17673583,0,480020
8174.940561532974,18159579,2988.0,17679431,0,480148
8176.944376707077,18164054,2237.5,17683785,0,480269
8178.944739341736,18169723,2834.5,17689309,0,480414
8180.944739818573,18175688,2982.5,17695117,0,480571
8182.945461273193,18181438,2875.0,17700714,0,480724
8184.952703475952,18187566,3064.0,17706676,0,480890
8186.952703714371,18193548,2991.0,17712497,0,481051
8188.952968835831,18199680,3066.0,17718466,0,481214
8190.961352109909,18205370,2845.0,17724006,0,481364
8192.976974248886,18211054,2842.0,17729551,0,481503
8194.984769105911,18215867,2406.5,17734259,0,481608
8196.99081325531,18221418,2775.5,17739657,0,481761
8199.002872467041,18227429,3005.5,17745492,0,481937
8201.013509988785,18232694,2632.5,17750617,0,482077
8203.027916669846,18238925,3115.5,17756685,0,482240
8205.029295682907,18245250,3162.5,17762862,0,482388
8207.035645484924,18251235,2992.5,17768690,0,482545
8209.036296606064,18257461,3113.0,17774757,0,482704
8211.045234441757,18263561,3050.0,17780680,0,482881
8213.053849458694,18269806,3122.5,17786764,0,483042
8215.059411764145,18275106,2650.0,17791909,0,483197
8217.061029911041,18281227,3060.5,17797872,0,483355
8219.076654434204,18287377,3075.0,17803850,0,483527
8221.085448741913,18293194,2908.5,17809516,0,483678
8223.098562717438,18299168,2987.0,17815337,0,483831
8225.114030838013,18304896,2864.0,17820913,0,483983
8227.116224765778,18310678,2891.0,17826560,0,484118
8229.117360591888,18316476,2899.0,17832182,0,484294
8231.1173620224,18322485,3004.5,17838024,0,484461
8233.117588758469,18328652,3083.5,17844019,0,484633
8235.121553897858,18334395,2871.5,17849603,0,484792
8237.12186741829,18340330,2967.5,17855378,0,484952
8239.131224393845,18345234,2452.0,17860164,0,485070
8241.133155345917,18351346,3056.0,17866120,0,485226
8243.133155584335,18357108,2881.0,17871745,0,485363
8245.1331782341,18363169,3030.5,17877629,0,485540
8247.144334554672,18368577,2704.0,17882901,0,485676
8249.151204586029,18374395,2909.0,17888593,0,485802
8251.152037620544,18380706,3155.5,17894759,0,485947
8253.155800819397,18385664,2479.0,17899581,0,486083
8255.162514209747,18391150,2743.0,17904933,0,486217
8257.172540187836,18397332,3091.0,17910951,0,486381
8259.188137054443,18403601,3134.5,17917038,0,486563
8261.189987421036,18408941,2670.0,17922223,0,486718
8263.202692270279,18412401,1730.0,17925585,0,486816
8265.207009792328,18418597,3098.0,17931619,0,486978
8267.22263455391,18424891,3147.0,17937735,0,487156
8269.22307395935,18430939,3024.0,17943615,0,487324
8271.238697052002,18437118,3089.5,17949633,0,487485
8273.238842964172,18443350,3116.0,17955716,0,487634
8275.254467487335,18449627,3138.5,17961842,0,487785
8277.254827260971,18455671,3022.0,17967705,0,487966
8279.265567779541,18461452,2890.5,17973346,0,488106
8281.265673160553,18466859,2703.5,17978615,0,488244
8283.270755529404,18471660,2400.5,17983298,0,488362
8285.280690431595,18477666,3003.0,17989145,0,488521
8287.280690908432,18483439,2886.5,17994772,0,488667
8289.286743164062,18489435,2998.0,18000632,0,488803
8291.295565128326,18495598,3081.5,18006629,0,488969
8293.297028779984,18499883,2142.5,18010819,0,489064
8295.299253702164,18503536,1826.5,18014386,0,489150
8297.299639940262,18509736,3100.0,18020432,0,489304
8299.300379514694,18515868,3066.0,18026395,0,489473
8301.301552772522,18520974,2553.0,18031373,0,489601
8303.302129745483,18525310,2168.0,18035604,0,489706
8305.317773580551,18531487,3088.5,18041627,0,489860
8307.33338522911,18535899,2206.0,18045932,0,489967
8309.34615778923,18540656,2378.5,18050572,0,490084
8311.347424983978,18546592,2968.0,18056347,0,490245
8313.350387096405,18551651,2529.5,18061269,0,490382
8315.350411653519,18556713,2531.0,18066200,0,490513
8317.3660094738,18562715,3001.0,18072039,0,490676
8319.377306222916,18568489,2887.0,18077651,0,490838
8321.37768793106,18574326,2918.5,18083322,0,491004
8323.377721071243,18580335,3004.5,18089172,0,491163
8325.393345832825,18586178,2921.5,18094845,0,491333
8327.39334654808,18591939,2880.5,18100445,0,491494
8329.399570941925,18597883,2972.0,18106247,0,491636
8331.39957356453,18603723,2920.0,18111947,0,491776
8333.415195941925,18609748,3012.5,18117821,0,491927
8335.415216684341,18615477,2864.5,18123404,0,492073
8337.421446800232,18621902,3212.5,18129656,0,492246
8339.4287276268,18627981,3039.5,18135581,0,492400
8341.444323539734,18634161,3090.0,18141600,0,492561
8343.444324493408,18640414,3126.5,18147692,0,492722
8345.459948778152,18646665,3125.5,18153781,0,492884
8347.46131825447,18652686,3010.5,18159640,0,493046
8349.463478088379,18658641,2977.5,18165452,0,493189
8351.476573944092,18664849,3104.0,18171494,0,493355
8353.477232456207,18670790,2970.5,18177284,0,493506
8355.47724032402,18676954,3082.0,18183299,0,493655
8357.49286866188,18683110,3078.0,18189283,0,493827
8359.505558729172,18689344,3117.0,18195355,0,493989
8361.51510977745,18695406,3031.0,18201243,0,494163
8363.515600919724,18701585,3089.5,18207259,0,494326
8365.524050474167,18707780,3097.5,18213307,0,494473
8367.524928092957,18714138,3179.0,18219488,0,494650
8369.536473989487,18720091,2976.5,18225282,0,494809
8371.55208992958,18726299,3104.0,18231332,0,494967
8373.554347991943,18732562,3131.5,18237425,0,495137
8375.566771745682,18738200,2819.0,18242917,0,495283
8377.570565462112,18744160,2980.0,18248708,0,495452
8379.585070848465,18750327,3083.5,18254709,0,495618
8381.60067152977,18756599,3136.0,18260833,0,495766
8383.60504102707,18762651,3026.0,18266723,0,495928
8385.612693786621,18768762,3055.5,18272671,0,496091
8387.621048688889,18774892,3065.0,18278645,0,496247
8389.621099472046,18781109,3108.5,18284694,0,496415
8391.62183046341,18787338,3114.5,18290765,0,496573
8393.633368492126,18793364,3013.0,18296634,0,496730
8395.64485859871,18799514,3075.0,18302609,0,496905
8397.646838188171,18805808,3147.0,18308749,0,497059
8399.64683842659,18811886,3039.0,18314682,0,497204
8401.656900405884,18818050,3082.0,18320668,0,497382
8403.661394834518,18824035,2992.5,18326491,0,497544
8405.666691303253,18830162,3063.5,18332454,0,497708
8407.666692733765,18836440,3139.0,18338566,0,497874
8409.671789169312,18842382,2971.0,18344340,0,498042
8411.684241771698,18848536,3077.0,18350334,0,498202
8413.691150903702,18854794,3129.0,18356430,0,498364
8415.699131250381,18861067,3136.5,18362543,0,498524
8417.71299648285,18867141,3037.0,18368464,0,498677
8419.724001407623,18873243,3051.0,18374420,0,498823
8421.724211454391,18879557,3157.0,18380559,0,498998
8423.732130527496,18885647,3045.0,18386494,0,499153
8425.740123033524,18891687,3020.0,18392373,0,499314
8427.74118423462,18897906,3109.5,18398421,0,499485
8429.74349474907,18904135,3114.5,18404486,0,499649
8431.748336076736,18910241,3053.0,18410429,0,499812
8433.74877691269,18916278,3018.5,18416305,0,499973
8435.760830640793,18921891,2806.5,18421780,0,500111
8437.761484146118,18927994,3051.5,18427736,0,500258
8439.761933326721,18934094,3050.0,18433683,0,500411
8441.774946212769,18939423,2664.5,18438874,0,500549
8443.786560297012,18945636,3106.5,18444950,0,500686
8445.794047832489,18952012,3188.0,18451141,0,500871
8447.797142505646,18958251,3119.5,18457251,0,501000
8449.797907829285,18964232,2990.5,18463088,0,501144
8451.807284355164,18970420,3094.0,18469109,0,501311
8453.81865119934,18976690,3135.0,18475229,0,501461
8455.8199300766,18982865,3087.5,18481246,0,501619
8457.830864906311,18989131,3133.0,18487331,0,501800
8459.839140892029,18995096,2982.5,18493140,0,501956
8461.839842796326,19001295,3099.5,18499195,0,502100
8463.842804908752,19007552,3128.5,18505302,0,502250
8465.852202415466,19013639,3043.5,18511240,0,502399
8467.867596626282,19019696,3028.5,18517136,0,502560
8469.871447563171,19025834,3069.0,18523113,0,502721
8471.87337756157,19032112,3139.0,18529243,0,502869
8473.874140739441,19038254,3071.0,18535224,0,503030
8475.8793861866,19044291,3018.5,18541084,0,503207
8477.881169319153,19050412,3060.5,18547032,0,503380
8479.882373094559,19056533,3060.5,18552997,0,503536
8481.89799785614,19062757,3112.0,18559067,0,503690
8483.898482084274,19068787,3015.0,18564928,0,503859
8485.914894580841,19074913,3063.0,18570887,0,504026
8487.915885925293,19081202,3144.5,18577042,0,504160
8489.919492483139,19087458,3128.0,18583152,0,504306
8491.922369241714,19093339,2940.5,18588880,0,504459
8493.925288677216,19099309,2985.0,18594702,0,504607
8495.930385112762,19105318,3004.5,18600556,0,504762
8497.940626382828,19111388,3035.0,18606445,0,504943
8499.953377962112,19117498,3055.0,18612380,0,505118
8501.960438489914,19123648,3075.0,18618364,0,505284
8503.964740037918,19129847,3099.5,18624393,0,505454
8505.980366230011,19136054,3103.5,18630441,0,505613
8507.981630802155,19142185,3065.5,18636419,0,505766
8509.9883248806,19148272,3043.5,18642334,0,505938
8511.995805501938,19154497,3112.5,18648402,0,506095
8513.995806455612,19160774,3138.5,18654535,0,506239
8516.010586738586,19166717,2971.5,18660331,0,506386
8518.011194705963,19172705,2994.0,18666159,0,506546
8520.026817321777,19178743,3019.0,18672043,0,506700
8522.028184890747,19184847,3052.0,18677991,0,506856
8524.031537771225,19190784,2968.5,18683765,0,507019
8526.042413949966,19196515,2865.5,18689355,0,507160
8528.058039188385,19202542,3013.5,18695236,0,507306
8530.059361219406,19208732,3095.0,18701256,0,507476
8532.07466006279,19214963,3115.5,18707316,0,507647
8534.075817346573,19221007,3022.0,18713189,0,507818
8536.076297283173,19227176,3084.5,18719197,0,507979
8538.085888147354,19233382,3103.0,18725245,0,508137
8540.086136341095,19239515,3066.5,18731230,0,508285
8542.095892190933,19245602,3043.5,18737144,0,508458
8544.096906661987,19251703,3050.5,18743078,0,508625
8546.11108326912,19257915,3106.0,18749110,0,508805
8548.119062662125,19263999,3042.0,18755051,0,508948
8550.119338274002,19270138,3069.5,18761023,0,509115
8552.124808073044,19276340,3101.0,18767070,0,509270
8554.140428066254,19282345,3002.5,18772927,0,509418
8556.140428066254,19288439,3047.0,18778860,0,509579
8558.14188528061,19294538,3049.5,18784802,0,509736
8560.142650842667,19300707,3084.5,18790810,0,509897
8562.151081085205,19306952,3122.5,18796897,0,510055
8564.156943321228,19313250,3149.0,18803020,0,510230
8566.162100791931,19319550,3150.0,18809174,0,510376
8568.169219970703,19325587,3018.5,18815036,0,510551
8570.16968345642,19331790,3101.5,18821068,0,510722
8572.184687376022,19338104,3157.0,18827209,0,510895
8574.200332641602,19344274,3085.0,18833220,0,511054
8576.206922531128,19350322,3024.0,18839109,0,511213
8578.208057403564,19356438,3058.0,18845072,0,511366
8580.208539485931,19362618,3090.0,18851092,0,511526
8582.209078550339,19368695,3038.5,18857009,0,511686
8584.21310043335,19374711,3008.0,18862852,0,511859
8586.22871184349,19380937,3113.0,18868917,0,512020
8588.24433541298,19387299,3181.0,18875117,0,512182
8590.248076915741,19393615,3158.0,18881259,0,512356
8592.257709980011,19399721,3053.0,18887218,0,512503
8594.258872032166,19405829,3054.0,18893143,0,512686
8596.259602546692,19412204,3187.5,18899336,0,512868
8598.268091201782,19418348,3072.0,18905321,0,513027
8600.268961906433,19424365,3008.5,18911187,0,513178
8602.284548044205,19430490,3062.5,18917158,0,513332
8604.284548521042,19435961,2735.5,18922484,0,513477
8606.29517531395,19441779,2909.0,18928160,0,513619
8608.296130657196,19447883,3052.0,18934102,0,513781
8610.303295850754,19454013,3065.0,18940088,0,513925
8612.303297042847,19460231,3109.0,18946151,0,514080
8614.307098150253,19465775,2772.0,18951550,0,514225
8616.30709862709,19471793,3009.0,18957411,0,514382
8618.30814743042,19478061,3134.0,18963520,0,514541
8620.320296764374,19484200,3069.5,18969504,0,514696
8622.335797786713,19490333,3066.5,18975478,0,514855
8624.335818529129,19496555,3111.0,18981525,0,515030
8626.337242126465,19502882,3163.5,18987685,0,515197
8628.347001314163,19508920,3019.0,18993593,0,515327
8630.350109577179,19514893,2986.5,18999419,0,515474
8632.350112199783,19521086,3096.5,19005437,0,515649
8634.365918636322,19527309,3111.5,19011508,0,515801
8636.381532669067,19533485,3088.0,19017515,0,515970
8638.388784646988,19539549,3032.0,19023424,0,516125
8640.398437261581,19545706,3078.5,19029397,0,516309
8642.402009248734,19552025,3159.5,19035562,0,516463
8644.40373301506,19558170,3072.5,19041558,0,516612
8646.403733253479,19564372,3101.0,19047606,0,516766
8648.419358253479,19570527,3077.5,19053596,0,516931
8650.429433345795,19576735,3104.0,19059670,0,517065
8652.440243244171,19583097,3181.0,19065880,0,517217
8654.441270828247,19589213,3058.0,19071829,0,517384
8656.450959444046,19595360,3073.5,19077806,0,517554
8658.466605186462,19601558,3099.0,19083841,0,517717
8660.482209682465,19607752,3097.0,19089884,0,517868
8662.482211828232,19613858,3053.0,19095840,0,518018
8664.497834444046,19619948,3045.0,19101770,0,518178
8666.497835159302,19626203,3127.5,19107851,0,518352
8668.512782812119,19631784,2790.5,19113283,0,518501
8670.523043394089,19637375,2795.5,19118735,0,518640
8672.534222602844,19643525,3075.0,19124740,0,518785
8674.544439077377,19649175,2825.0,19130244,0,518931
8676.549895524979,19655146,2985.5,19136079,0,519067
8678.558708906174,19661117,2985.5,19141911,0,519206
8680.561074972153,19666936,2909.5,19147591,0,519345
8682.565554857254,19671886,2475.0,19152419,0,519467
8684.578113555908,19677388,2751.0,19157769,0,519619
8686.58042383194,19683115,2863.5,19163341,0,519774
8688.5813934803,19689226,3055.5,19169299,0,519927
8690.583595514297,19695496,3135.0,19175413,0,520083
8692.589816331863,19701339,2921.5,19181074,0,520265
8694.59142613411,19707127,2894.0,19186716,0,520411
8696.60165810585,19713298,3085.5,19192719,0,520579
8698.60659122467,19719433,3067.5,19198668,0,520765
8700.61172747612,19725383,2975.0,19204457,0,520926
8702.614223480225,19730508,2562.5,19209444,0,521064
8704.629748344421,19734063,1777.5,19212905,0,521158
8706.642188549042,19739410,2673.5,19218123,0,521287
8708.653947591782,19745530,3060.0,19224078,0,521452
8710.656449317932,19751736,3103.0,19230131,0,521605
8712.660629987717,19757996,3130.0,19236217,0,521779
8714.671182394028,19764037,3020.5,19242102,0,521935
8716.676956892014,19769734,2848.5,19247644,0,522090
8718.686135530472,19775787,3026.5,19253542,0,522245
8720.697142601013,19781865,3039.0,19259453,0,522412
8722.708734035492,19788081,3108.0,19265504,0,522577
8724.719541549683,19794222,3070.5,19271503,0,522719
8726.721500873566,19800384,3081.0,19277516,0,522868
8728.734884500504,19806647,3131.5,19283615,0,523032
8730.745609045029,19812811,3082.0,19289622,0,523189
8732.760397434235,19819034,3111.5,19295662,0,523372
8734.768256664276,19824736,2851.0,19301213,0,523523
8736.779341697693,19830805,3034.5,19307124,0,523681
8738.794072151184,19837132,3163.5,19313276,0,523856
8740.805588960648,19841658,2263.0,19317681,0,523977
8742.816629886627,19845994,2168.0,19321921,0,524073
8744.828351259232,19852229,3117.5,19327970,0,524259
8746.839181184769,19858520,3145.5,19334094,0,524426
8748.850476264954,19864552,3016.0,19339972,0,524580
8750.861285924911,19870782,3115.0,19346044,0,524738
8752.865335702896,19876994,3106.0,19352097,0,524897
8754.866798400879,19883236,3121.0,19358179,0,525057
8756.877871751785,19889335,3049.5,19364123,0,525212
8758.888391256332,19895483,3074.0,19370125,0,525358
8760.899309396744,19901732,3124.5,19376222,0,525510
8762.901229143143,19907891,3079.5,19382214,0,525677
8764.912000894547,19914071,3090.0,19388243,0,525828
8766.918220996857,19920343,3136.0,19394360,0,525983
8768.928780317307,19926607,3132.0,19400459,0,526148
8770.94481086731,19932872,3132.5,19406538,0,526334
8772.955560207367,19938895,3011.5,19412407,0,526488
8774.966787338257,19945102,3103.5,19418421,0,526681
8776.977791786194,19951371,3134.5,19424515,0,526856
8778.988531589508,19957530,3079.5,19430521,0,527009
8780.988739490509,19963615,3042.5,19436448,0,527167
8782.990387439728,19969695,3040.0,19442374,0,527321
8785.00505399704,19976110,3207.5,19448618,0,527492
8787.015993595123,19982245,3067.5,19454588,0,527657
8789.019126415253,19988360,3057.5,19460555,0,527805
8791.029624462128,19994663,3151.5,19466687,0,527976
8793.041284561157,20001046,3191.5,19472900,0,528146
8795.055355548859,20006848,2901.0,19478543,0,528305
8797.066497087479,20012965,3058.5,19484512,0,528453
8799.07063961029,20019144,3089.5,19490531,0,528613
8801.08140873909,20025423,3139.5,19496660,0,528763
8803.092195987701,20031703,3140.0,19502772,0,528931
8805.103492975235,20038030,3163.5,19508922,0,529108
8807.114986896515,20043987,2978.5,19514716,0,529271
8809.127107858658,20046891,1452.0,19517558,0,529333
8811.138022184372,20052523,2816.0,19523014,0,529509
8813.138669967651,20058515,2996.0,19528838,0,529677
8815.144148349762,20064751,3118.0,19534930,0,529821
8817.15464091301,20070989,3119.0,19541002,0,529987
8819.165606975555,20076991,3001.0,19546832,0,530159
8821.176620483398,20083143,3076.0,19552821,0,530322
8823.187449932098,20089184,3020.5,19558699,0,530485
8825.189636707306,20095303,3059.5,19564668,0,530635
8827.200235128403,20101322,3009.5,19570511,0,530811
8829.215543031693,20107275,2976.5,19576315,0,530960
8831.231041431427,20113340,3032.5,19582209,0,531131
8833.238816738129,20119441,3050.5,19588132,0,531309
8835.249692678452,20125745,3152.0,19594242,0,531503
8837.261211633682,20131950,3102.5,19600289,0,531661
8839.26884508133,20138049,3049.5,19606233,0,531816
8841.279386997223,20144210,3080.5,19612216,0,531994
8843.289991378784,20149692,2741.0,19617563,0,532129
8845.300817489624,20155275,2791.5,19623008,0,532267
8847.311552286148,20161123,2924.0,19628700,0,532423
8849.316672086716,20167215,3046.0,19634620,0,532595
8851.32725739479,20173446,3115.5,19640670,0,532776
8853.33644270897,20179534,3044.0,19646598,0,532936
8855.340556144714,20185265,2865.5,19652177,0,533088
8857.351678609848,20191466,3100.5,19658233,0,533233
8859.364392280579,20197215,2874.5,19663843,0,533372
8861.37644314766,20203414,3099.5,19669877,0,533537
8863.378458023071,20208820,2703.0,19675140,0,533680
8865.389641523361,20211854,1517.0,19678094,0,533760
8867.401411533356,20215683,1914.5,19681838,0,533845
8869.412447214127,20221789,3053.0,19687787,0,534002
8871.422966241837,20228073,3142.0,19693906,0,534167
8873.433789014816,20234347,3137.0,19700009,0,534338
8875.444622039795,20240576,3114.5,19706051,0,534525
8877.45639038086,20246674,3049.0,19712006,0,534668
8879.467500448227,20252884,3105.0,19718057,0,534827
8881.473187923431,20259011,3063.5,19724018,0,534993
8883.484806537628,20264985,2987.0,19729840,0,535145
8885.495802164078,20271039,3027.0,19735738,0,535301
8887.510648012161,20277340,3150.5,19741876,0,535464
8889.521116256714,20283660,3160.0,19748042,0,535618
8891.532217502594,20289799,3069.5,19754014,0,535785
8893.535295724869,20295973,3087.0,19760010,0,535963
8895.545911073685,20301999,3013.0,19765872,0,536127
8897.560943841934,20308253,3127.0,19771962,0,536291
8899.583899736404,20314346,3046.5,19777914,0,536432
8901.598049879074,20320546,3100.0,19783963,0,536583
8903.60856795311,20326841,3147.5,19790107,0,536734
8905.619538545609,20333125,3142.0,19796223,0,536902
8907.63024520874,20339371,3123.0,19802310,0,537061
8909.641324520111,20345466,3047.5,19808235,0,537231
8911.652067899704,20349856,2195.0,19812497,0,537359
8913.661563634872,20355260,2702.0,19817764,0,537496
8915.668342113495,20360606,2673.0,19822963,0,537643
8917.671191215515,20366427,2910.5,19828619,0,537808
8919.682255744934,20372088,2830.5,19834138,0,537950
8921.692998409271,20378130,3021.0,19840033,0,538097
8923.693871974945,20384224,3047.0,19845970,0,538254
8925.704603672028,20390402,3089.0,19851992,0,538410
8927.715467691422,20396723,3160.5,19858154,0,538569
8929.72618508339,20403038,3157.5,19864309,0,538729
8931.737025499344,20409171,3066.5,19870280,0,538891
8933.747853040695,20415456,3142.5,19876390,0,539066
8935.76094007492,20421799,3171.5,19882547,0,539252
8937.761494874954,20428019,3110.0,19888596,0,539423
8939.773337125778,20434120,3050.5,19894511,0,539609
8941.784043312073,20440419,3149.5,19900641,0,539778
8943.794833421707,20446682,3131.5,19906753,0,539929
8945.805244207382,20452868,3093.0,19912757,0,540111
8947.812911748886,20458978,3055.0,19918715,0,540263
8949.823392629623,20465254,3138.0,19924837,0,540417
8951.833971738815,20471591,3168.5,19931006,0,540585
8953.84367275238,20477728,3068.5,19936986,0,540742
8955.848937988281,20482179,2225.5,19941338,0,540841
8957.859704971313,20487058,2439.5,19946082,0,540976
8959.870293617249,20493235,3088.5,19952086,0,541149
8961.880859851837,20499501,3133.0,19958174,0,541327
8963.89332818985,20505639,3069.0,19964137,0,541502
8965.903885126114,20511891,3126.0,19970239,0,541652
8967.914911985397,20518188,3148.5,19976370,0,541818
8969.931066513062,20524444,3128.0,19982452,0,541992
8971.945446491241,20530348,2952.0,19988195,0,542153
8973.960576534271,20536340,2996.0,19994026,0,542314
8975.9714782238,20542337,2998.5,19999860,0,542477
8977.982163667679,20548543,3103.0,20005893,0,542650
8979.993576526642,20554597,3027.0,20011783,0,542814
8982.00410103798,20560737,3070.0,20017774,0,542963
8984.014997959137,20566976,3119.5,20023859,0,543117
8986.029177904129,20573280,3152.0,20029993,0,543287
8988.030458688736,20579192,2956.0,20035759,0,543433
8990.041501522064,20584371,2589.5,20040788,0,543583
8992.052564382553,20588894,2261.5,20045183,0,543711
8994.062975645065,20595097,3101.5,20051230,0,543867
8996.072631597519,20601270,3086.5,20057237,0,544033
8998.077803611755,20607468,3099.0,20063268,0,544200
9000.088537931442,20613745,3138.5,20069371,0,544374
9002.100823640823,20619925,3090.0,20075362,0,544563
9004.111379623413,20626072,3073.5,20081342,0,544730
9006.121863126755,20632307,3117.5,20087401,0,544906
9008.132686853409,20638638,3165.5,20093565,0,545073
9010.143451929092,20644847,3104.5,20099605,0,545242
9012.159512996674,20650936,3044.5,20105532,0,545404
9014.169900655746,20657143,3103.5,20111575,0,545568
9016.181182861328,20663547,3202.0,20117824,0,545723
9018.191583395004,20669864,3158.5,20123993,0,545871
9020.202673912048,20676025,3080.5,20129979,0,546046
9022.214090824127,20682214,3094.5,20136019,0,546195
9024.228327989578,20686403,2094.5,20140112,0,546291
9026.243281126022,20692128,2862.5,20145668,0,546460
9028.253773212433,20697839,2855.5,20151232,0,546607
9030.259115695953,20703526,2843.5,20156778,0,546748
9032.264852285385,20709673,3073.5,20162754,0,546919
9034.275352478027,20715538,2932.5,20168476,0,547062
9036.278421878815,20721498,2980.0,20174278,0,547220
9038.289004325867,20727778,3140.0,20180389,0,547389
9040.29992556572,20734044,3133.0,20186489,0,547555
9042.309803247452,20740210,3083.0,20192485,0,547725
9044.320594072342,20746245,3017.5,20198361,0,547884
9046.331510782242,20752507,3131.0,20204459,0,548048
9048.341994524002,20758794,3143.5,20210598,0,548196
9050.357266664505,20765094,3150.0,20216740,0,548354
9052.37010550499,20771088,2997.0,20222575,0,548513
9054.37156176567,20777250,3081.0,20228561,0,548689
9056.38277888298,20783584,3167.0,20234743,0,548841
9058.394097805023,20789856,3136.0,20240836,0,549020
9060.404816865921,20795942,3043.0,20246774,0,549168
9062.408081293106,20802104,3081.0,20252787,0,549317
9064.418285369873,20808371,3133.5,20258897,0,549474
9066.421275377274,20814501,3065.0,20264901,0,549600
9068.435123443604,20820620,3059.5,20270861,0,549759
9070.445637226105,20826878,3129.0,20276960,0,549918
9072.45657658577,20833242,3182.0,20283164,0,550078
9074.467435836792,20839379,3068.5,20289131,0,550248
9076.468848466873,20845503,3062.0,20295108,0,550395
9078.482111692429,20851653,3075.0,20301093,0,550560
9080.49309372902,20857992,3169.5,20307259,0,550733
9082.50803899765,20864119,3063.5,20313240,0,550879
9084.518541574478,20870301,3091.0,20319266,0,551035
9086.529389619827,20876556,3127.5,20325378,0,551178
9088.541263341904,20882893,3168.5,20331554,0,551339
9090.552047014236,20889029,3068.0,20337542,0,551487
9092.563289642334,20895167,3069.0,20343527,0,551640
9094.569384098053,20901116,2974.5,20349328,0,551788
9096.574499130249,20907059,2971.5,20355125,0,551934
9098.587372779846,20913079,3010.0,20360977,0,552102
9100.589992523193,20919213,3067.0,20366934,0,552279
9102.60110783577,20925451,3119.0,20373003,0,552448
9104.612030506134,20931503,3026.0,20378898,0,552605
9106.62289428711,20937570,3033.5,20384768,0,552802
9108.633733987808,20943782,3106.0,20390823,0,552959
9110.644435882568,20950003,3110.5,20396879,0,553124
9112.648177146912,20956079,3038.0,20402795,0,553284
9114.653970956802,20962231,3076.0,20408789,0,553442
9116.663222789764,20968398,3083.5,20414797,0,553601
9118.675073862076,20974462,3032.0,20420692,0,553770
9120.688952922821,20980456,2997.0,20426524,0,553932
9122.700162410736,20986604,3074.0,20432520,0,554084
9124.710805416107,20992596,2996.0,20438354,0,554242
9126.721823215485,20998640,3022.0,20444243,0,554397
9128.723305940628,21004350,2855.0,20449811,0,554539
9130.733882904053,21010451,3050.5,20455747,0,554704
9132.747526407242,21016577,3063.0,20461710,0,554867
9134.758201360703,21020485,1954.0,20465497,0,554988
9136.768813848495,21026508,3011.5,20471382,0,555126
9138.778980970383,21032714,3103.0,20477418,0,555296
9140.790818214417,21038982,3134.0,20483529,0,555453
9142.801747322083,21045215,3116.5,20489587,0,555628
9144.810103654861,21051323,3054.0,20495535,0,555788
9146.823725938797,21057455,3066.0,20501514,0,555941
9148.83825302124,21063657,3101.0,20507547,0,556110
9150.848964452744,21069762,3052.5,20513497,0,556265
9152.859744548798,21075872,3055.0,20519455,0,556417
9154.868906736374,21081497,2812.5,20524906,0,556591
9156.873310565948,21087700,3101.5,20530941,0,556759
9158.883719205856,21093778,3039.0,20536854,0,556924
9160.889378070831,21099868,3045.0,20542789,0,557079
9162.900301933289,21105980,3056.0,20548736,0,557244
9164.900319814682,21112346,3183.0,20554927,0,557419
9166.911705970764,21118516,3085.0,20560926,0,557590
9168.922201395035,21124669,3076.5,20566928,0,557741
9170.925560235977,21130889,3110.0,20572971,0,557918
9172.936378240585,21137152,3131.5,20579073,0,558079
9174.947232484818,21143163,3005.5,20584941,0,558222
9176.961837053299,21149309,3073.0,20590907,0,558402
9178.972178936005,21155592,3141.5,20597031,0,558561
9180.982829809189,21161798,3103.0,20603054,0,558744
9182.994210004807,21167650,2926.0,20608765,0,558885
9185.003978729248,21173670,3010.0,20614654,0,559016
9187.008751392365,21179965,3147.5,20620766,0,559199
9189.019659757614,21186190,3112.5,20626796,0,559394
9191.030368089676,21192403,3106.5,20632842,0,559561
9193.041160821915,21198534,3065.5,20638814,0,559720
9195.052027702332,21204740,3103.0,20644845,0,559895
9197.063312530518,21211089,3174.5,20651020,0,560069
9199.075924396515,21217086,2998.5,20656857,0,560229
9201.08689570427,21223323,3118.5,20662926,0,560397
9203.100500106812,21229548,3112.5,20668965,0,560583
9205.11257314682,21234019,2235.5,20673302,0,560717
9207.127029657364,21240071,3026.0,20679186,0,560885
9209.1292450428,21243979,1954.0,20683010,0,560969
9211.137603998184,21250221,3121.0,20689093,0,561128
9213.144709348679,21256421,3100.0,20695145,0,561276
9215.147228240967,21262081,2830.0,20700667,0,561414
9217.157876968384,21267028,2473.5,20705502,0,561526
9219.170976400375,21270716,1844.0,20709100,0,561616
9221.182212591171,21274561,1922.5,20712850,0,561711
9223.195234537125,21280097,2768.0,20718250,0,561847
9225.209591388702,21285789,2846.0,20723799,0,561990
9227.216636896133,21291687,2949.0,20729539,0,562148
9229.22723531723,21297708,3010.5,20735407,0,562301
9231.243695735931,21301004,1648.0,20738638,0,562366
9233.255779981613,21306562,2779.0,20744052,0,562510
9235.266464710236,21312057,2747.5,20749386,0,562671
9237.268519163132,21317547,2745.0,20754734,0,562813
9239.278994083405,21323307,2880.0,20760336,0,562971
9241.289507865906,21329095,2894.0,20765947,0,563148
9243.30000782013,21335084,2994.5,20771768,0,563316
9245.310742616653,21340528,2722.0,20777062,0,563466
9247.335991621017,21343891,1681.5,20780353,0,563538
9249.346977710724,21349775,2942.0,20786081,0,563694
9251.359125852585,21355063,2644.0,20791234,0,563829
9253.369678735733,21359839,2388.0,20795878,0,563961
9255.380753040314,21364224,2192.5,20800143,0,564081
9257.391395330429,21370166,2971.0,20805924,0,564242
9259.396453619003,21375898,2866.0,20811503,0,564395
9261.407368421555,21382158,3130.0,20817583,0,564575
9263.418020963669,21386673,2257.5,20821978,0,564695
9265.427486896515,21392165,2746.0,20827314,0,564851
9267.438276290894,21398298,3066.5,20833303,0,564995
9269.451209306717,21404648,3175.0,20839506,0,565142
9271.462308883667,21410848,3100.0,20845540,0,565308
9273.47207069397,21416882,3017.0,20851416,0,565466
9275.482984304428,21422558,2838.0,20856937,0,565621
9277.484731674194,21428541,2991.5,20862766,0,565775
9279.49522304535,21434194,2826.5,20868255,0,565939
9281.506771564484,21439975,2890.5,20873888,0,566087
9283.518047332764,21446207,3116.0,20879953,0,566254
9285.528554439545,21451771,2782.0,20885372,0,566399
9287.539222240448,21456575,2402.0,20890045,0,566530
9289.550181150436,21461850,2637.5,20895179,0,566671
9291.561039447784,21467853,3001.5,20901012,0,566841
9293.571851491928,21473613,2880.0,20906620,0,566993
9295.582491874695,21479811,3099.0,20912670,0,567141
9297.584297180176,21483864,2026.5,20916622,0,567242
9299.599713802338,21489661,2898.5,20922266,0,567395
9301.611579179764,21495943,3141.0,20928405,0,567538
9303.622041940689,21502169,3113.0,20934477,0,567692
9305.63261961937,21506582,2206.5,20938794,0,567788
9307.641401052475,21512517,2967.5,20944577,0,567940
9309.641994714737,21518405,2944.0,20950326,0,568079
9311.654200077057,21524169,2882.0,20955924,0,568245
9313.665624380112,21530149,2990.0,20961761,0,568388
9315.676603794098,21536204,3027.5,20967650,0,568554
9317.6871073246,21542517,3156.5,20973806,0,568711
9319.697900772095,21546378,1930.5,20977578,0,568800
9321.702929496765,21551419,2520.5,20982495,0,568924
9323.713899612427,21556024,2302.5,20986985,0,569039
9325.725291252136,21561303,2639.5,20992135,0,569168
9327.736099720001,21565977,2337.0,20996691,0,569286
9329.747484445572,21571936,2979.5,21002472,0,569464
9331.758829593658,21576216,2140.0,21006638,0,569578
9333.769888877869,21581791,2787.5,21012073,0,569718
9335.781662464142,21587541,2875.0,21017674,0,569867
9337.792288541794,21593436,2947.5,21023424,0,570012
9339.806643009186,21599266,2915.0,21029082,0,570184
9341.8172519207,21605293,3013.5,21034958,0,570335
9343.8277759552,21611135,2921.0,21040649,0,570486
9345.842655181885,21616923,2894.0,21046270,0,570653
9347.853196144104,21623023,3050.0,21052221,0,570802
9349.863671064377,21629048,3012.5,21058083,0,570965
9351.874125480652,21634740,2846.0,21063640,0,571100
9353.884999036789,21640803,3031.5,21069573,0,571230
9355.896879911423,21646546,2871.5,21075165,0,571381
9357.909867286682,21652389,2921.5,21080867,0,571522
9359.925384998322,21656687,2149.0,21085048,0,571639
9361.93264079094,21660911,2112.0,21089167,0,571744
9363.934953212738,21666296,2692.5,21094393,0,571903
9365.94784617424,21671902,2803.0,21099856,0,572046
9367.958340883255,21678120,3109.0,21105906,0,572214
9369.96985411644,21684237,3058.5,21111867,0,572370
9371.9809923172,21690513,3138.0,21117986,0,572527
9373.991594314575,21696838,3162.5,21124150,0,572688
9376.006659984589,21702844,3003.0,21129990,0,572854
9378.018954753876,21708963,3059.5,21135947,0,573016
9380.029881715775,21715093,3065.0,21141925,0,573168
9382.040765285492,21721428,3167.5,21148092,0,573336
9384.051396369934,21727629,3100.5,21154148,0,573481
9386.061952590942,21733740,3055.5,21160099,0,573641
9388.066446065903,21738112,2186.0,21164351,0,573761
9390.079143047333,21743666,2777.0,21169764,0,573902
9392.091915369034,21749517,2925.5,21175479,0,574038
9394.094776391983,21755239,2861.0,21181033,0,574206
9396.106305837631,21761022,2891.5,21186674,0,574348
9398.117124080658,21766940,2959.0,21192431,0,574509
9400.122593641281,21771837,2448.5,21197207,0,574630
9402.135379076004,21777467,2815.0,21202703,0,574764
9404.148410320282,21782290,2411.5,21207407,0,574883
9406.15920472145,21787772,2741.0,21212750,0,575022
9408.164921760559,21793676,2952.0,21218489,0,575187
9410.175518035889,21799565,2944.5,21224220,0,575345
9412.185986042023,21805605,3020.0,21230096,0,575509
9414.196514129639,21811765,3080.0,21236082,0,575683
9416.20749258995,21816599,2417.0,21240794,0,575805
9418.218240976334,21822652,3026.5,21246659,0,575993
9420.228743553162,21827460,2404.0,21251330,0,576130
9422.23977971077,21831649,2094.5,21255402,0,576247
9424.250621795654,21837644,2997.5,21261234,0,576410
9426.261541128159,21842486,2421.0,21265921,0,576565
9428.272154569626,21848494,3004.0,21271769,0,576725
9430.282823562622,21853304,2405.0,21276455,0,576849
9432.293943405151,21857402,2049.0,21280438,0,576964
9434.305698156357,21862774,2686.0,21285678,0,577096
9436.316565036774,21868448,2837.0,21291217,0,577231
9438.327381849289,21874460,3006.0,21297060,0,577400
9440.338458538055,21880604,3072.0,21303052,0,577552
9442.350134134293,21886835,3115.5,21309126,0,577709
9444.36176109314,21893053,3109.0,21315178,0,577875
9446.372227668762,21899088,3017.5,21321053,0,578035
9448.379184246063,21905225,3068.5,21327019,0,578206
9450.38115143776,21911411,3093.0,21333031,0,578380
9452.39174413681,21917605,3097.0,21339075,0,578530
9454.40240764618,21922784,2589.5,21344109,0,578675
9456.413541316986,21928244,2730.0,21349427,0,578817
9458.424513816833,21934473,3114.5,21355498,0,578975
9460.43549823761,21940739,3133.0,21361609,0,579130
9462.440759897232,21946850,3055.5,21367576,0,579274
9464.451626062393,21953008,3079.0,21373558,0,579450
9466.463110685349,21959235,3113.5,21379618,0,579617
9468.472441196442,21962765,1765.0,21383058,0,579707
9470.488146781921,21967702,2468.5,21387858,0,579844
9472.498907089233,21971893,2095.5,21391945,0,579948
9474.503256082535,21977762,2934.5,21397645,0,580117
9476.515406370163,21983882,3060.0,21403600,0,580282
9478.52470421791,21990071,3094.5,21409636,0,580435
9480.535670518875,21996136,3032.5,21415554,0,580582
9482.54643535614,22002193,3028.5,21421464,0,580729
9484.557106018066,22008460,3133.5,21427560,0,580900
9486.568865776062,22014532,3036.0,21433501,0,581031
9488.584954500198,22020641,3054.5,21439462,0,581179
9490.596103429794,22026662,3010.5,21445336,0,581326
9492.60721898079,22031445,2391.5,21450003,0,581442
9494.613085269928,22037247,2901.0,21455644,0,581603
9496.624002218246,22040693,1723.0,21459009,0,581684
9498.635079145432,22045917,2612.0,21464099,0,581818
9500.647162914276,22052150,3116.5,21470166,0,581984
9502.657944917679,22058286,3068.0,21476128,0,582158
9504.668376922607,22064288,3001.0,21481965,0,582323
9506.68015241623,22070326,3019.0,21487848,0,582478
9508.690903902054,22074544,2109.0,21491969,0,582575
9510.702389001846,22080689,3072.5,21497960,0,582729
9512.715031862259,22086785,3048.0,21503914,0,582871
9514.731115579605,22092505,2860.0,21509473,0,583032
9516.741993188858,22098802,3148.5,21515594,0,583208
9518.753014087677,22103680,2439.0,21520347,0,583333
9520.764205932617,22108252,2286.0,21524808,0,583444
9522.765867471695,22113995,2871.5,21530411,0,583584
9524.772898197174,22117446,1725.5,21533785,0,583661
9526.784202814102,22122917,2735.5,21539131,0,583786
9528.796639919281,22128914,2998.5,21544959,0,583955
9530.807568073273,22135130,3108.0,21551032,0,584098
9532.81847500801,22141451,3160.5,21557205,0,584246
9534.82637667656,22146352,2450.5,21561976,0,584376
9536.828056812286,22150788,2218.0,21566307,0,584481
9538.835977315903,22155137,2174.5,21570545,0,584592
9540.84705233574,22159044,1953.5,21574363,0,584681
9542.858747005463,22162804,1880.0,21578031,0,584773
9544.86984705925,22166829,2012.5,21581959,0,584870
9546.880906581879,22172508,2839.5,21587493,0,585015
9548.891698122025,22178418,2955.0,21593251,0,585167
9550.902906179428,22184663,3122.5,21599329,0,585334
9552.911818504333,22190716,3026.5,21605212,0,585504
9554.92276263237,22196955,3119.5,21611260,0,585695
9556.925095319748,22203202,3123.5,21617361,0,585841
9558.93739271164,22209245,3021.5,21623266,0,585979
9560.94283914566,22215379,3067.0,21629245,0,586134
9562.953899145126,22221550,3085.5,21635241,0,586309
9564.968698263168,22227958,3204.0,21641484,0,586474
9566.973076343536,22234050,3046.0,21647427,0,586623
9568.988546133041,22239350,2650.0,21652588,0,586762
9571.00002193451,22244666,2658.0,21657767,0,586899
9573.010851621628,22250533,2933.5,21663484,0,587049
9575.024355173111,22256314,2890.5,21669120,0,587194
9577.035833120346,22262397,3041.5,21675053,0,587344
9579.047368049622,22267306,2454.5,21679843,0,587463
9581.058957099915,22272886,2790.0,21685278,0,587608
9583.061259746552,22278449,2781.5,21690691,0,587758
9585.07248210907,22284596,3073.5,21696662,0,587934
9587.083623170853,22290332,2868.0,21702234,0,588098
9589.094663381577,22295223,2445.5,21706997,0,588226
9591.103350162506,22301028,2902.5,21712652,0,588376
9593.116357088089,22307277,3124.5,21718733,0,588544
9595.127341270447,22313456,3089.5,21724733,0,588723
9597.133347988129,22319480,3012.0,21730592,0,588888
9599.146553754807,22324354,2437.0,21735343,0,589011
9601.157228708267,22330644,3145.0,21741472,0,589172
9603.168089866638,22336907,3131.5,21747550,0,589357
9605.182298898697,22343026,3059.5,21753513,0,589513
9607.193724870682,22349155,3064.5,21759473,0,589682
9609.204358100891,22355278,3061.5,21765416,0,589862
9611.215041399002,22361395,3058.5,21771367,0,590028
9613.229614973068,22367493,3049.0,21777289,0,590204
9615.241068601608,22373616,3061.5,21783251,0,590365
9617.254553079605,22379684,3034.0,21789162,0,590522
9619.262246131897,22384607,2461.5,21793948,0,590659
9621.275146961212,22390199,2796.0,21799396,0,590803
9623.286344051361,22396296,3048.5,21805329,0,590967
9625.295496463776,22402479,3091.5,21811344,0,591135
9627.306193113327,22408809,3165.0,21817517,0,591292
9629.30623960495,22414892,3041.5,21823453,0,591439
9631.322072029114,22419309,2208.5,21827773,0,591536
9633.329168081284,22423643,2167.0,21831994,0,591649
9635.33337855339,22428449,2403.0,21836681,0,591768
9637.346039772034,22434214,2882.5,21842291,0,591923
9639.3570458889,22440448,3117.0,21848373,0,592075
9641.368128538132,22446654,3103.0,21854444,0,592210
9643.379374027252,22452843,3094.5,21860458,0,592385
9645.392417669296,22459027,3092.0,21866464,0,592563
9647.399340867996,22465157,3065.0,21872422,0,592735
9649.411079883575,22471376,3109.5,21878472,0,592904
9651.42249917984,22477649,3136.5,21884587,0,593062
9653.433114051819,22483738,3044.5,21890517,0,593221
9655.438832521439,22489797,3029.5,21896419,0,593378
9657.450814723969,22495904,3053.5,21902371,0,593533
9659.461994409561,22501851,2973.5,21908157,0,593694
9661.474260568619,22507739,2944.0,21913891,0,593848
9663.485840559006,22513462,2861.5,21919464,0,593998
9665.498338222504,22519754,3146.0,21925587,0,594167
9667.509188652039,22526022,3134.0,21931701,0,594321
9669.52025938034,22532259,3118.5,21937763,0,594496
9671.531117916107,22538306,3023.5,21943628,0,594678
9673.545592784882,22543851,2772.5,21949012,0,594839
9675.557568311691,22549729,2939.0,21954750,0,594979
9677.56824016571,22553041,1656.0,21957993,0,595048
9679.578780412674,22558581,2770.0,21963374,0,595207
9681.589756011963,22561436,1427.5,21966167,0,595269
9683.59088563919,22565387,1975.5,21970004,0,595383
9685.602603435516,22570852,2732.5,21975327,0,595525
9687.616013765335,22576868,3008.0,21981177,0,595691
9689.628328084946,22582767,2949.5,21986931,0,595836
9691.640290021896,22588624,2928.5,21992644,0,595980
9693.641494989395,22593034,2205.0,21996954,0,596080
9695.6543238163,22598192,2579.0,22001981,0,596211
9697.656409978867,22604296,3052.0,22007961,0,596335
9699.668370962143,22610407,3055.5,22013905,0,596502
9701.673549890518,22616498,3045.5,22019838,0,596660
9703.689901828766,22622596,3049.0,22025791,0,596805
9705.706249713898,22628895,3149.5,22031934,0,596961
9707.718408584595,22635157,3131.0,22038017,0,597140
9709.731262683868,22641324,3083.5,22043997,0,597327
9711.744144916534,22647329,3002.5,22049843,0,597486
9713.754849433899,22653413,3042.0,22055757,0,597656
9715.767663478851,22659681,3134.0,22061846,0,597835
9717.770282506943,22665715,3017.0,22067726,0,597989
9719.783415317535,22671684,2984.5,22073518,0,598166
9721.795553922653,22677737,3026.5,22079428,0,598309
9723.807418346405,22683978,3120.5,22085511,0,598467
9725.818154335022,22690024,3023.0,22091383,0,598641
9727.828732013702,22695751,2863.5,22096961,0,598790
9729.836700677872,22701691,2970.0,22102749,0,598942
9731.84777379036,22707696,3002.5,22108595,0,599101
9733.858622550964,22713601,2952.5,22114311,0,599290
9735.872186660767,22719461,2930.0,22120013,0,599448
9737.877784013748,22723756,2147.5,22124180,0,599576
9739.890216112137,22729448,2846.0,22129735,0,599713
9741.903313398361,22735239,2895.5,22135369,0,599870
9743.914146900177,22739630,2195.5,22139651,0,599979
9745.92614197731,22745913,3141.5,22145757,0,600156
9747.933614969254,22751868,2977.5,22151566,0,600302
9749.938281297684,22757837,2984.5,22157372,0,600465
9751.950059652328,22763940,3051.5,22163315,0,600625
9753.963189840317,22768606,2333.0,22167873,0,600733
9755.974133729935,22774010,2702.0,22173116,0,600894
9757.989740133286,22780122,3056.0,22179056,0,601066
9760.002875089645,22786287,3082.5,22185054,0,601233
9762.01666522026,22790958,2335.5,22189591,0,601367
9764.027553081512,22796336,2689.0,22194808,0,601528
9766.027678012848,22802334,2999.0,22200648,0,601686
9768.040604114532,22806524,2095.0,22204757,0,601767
9770.05367398262,22812186,2831.0,22210278,0,601908
9772.06012248993,22818123,2968.5,22216047,0,602076
9774.072269201279,22824148,3012.5,22221917,0,602231
9776.087966442108,22830370,3111.0,22227974,0,602396
9778.099367380142,22835200,2415.0,22232666,0,602534
9780.11133813858,22840980,2890.0,22238299,0,602681
9782.123345375061,22845396,2208.0,22242601,0,602795
9784.126062631607,22848767,1685.5,22245886,0,602881
9786.137701511383,22852983,2108.0,22249996,0,602987
9788.147060394287,22856270,1643.5,22253192,0,603078
9790.160655260086,22861659,2694.5,22258443,0,603216
9792.173283338547,22866999,2670.0,22263638,0,603361
9794.18850684166,22872006,2503.5,22268482,0,603524
9796.195339918137,22877857,2925.5,22274194,0,603663
9798.200134038925,22883683,2913.0,22279855,0,603828
9800.213784456253,22888045,2181.0,22284114,0,603931
9802.217752933502,22892018,1986.5,22287982,0,604036
9804.228732585907,22895819,1900.5,22291685,0,604134
9806.239678382874,22901843,3012.0,22297556,0,604287
9808.250902175903,22907990,3073.5,22303554,0,604436
9810.26508140564,22914105,3057.5,22309502,0,604603
9812.2756960392,22920183,3039.0,22315435,0,604748
9814.28793001175,22925600,2708.5,22320711,0,604889
9816.300728321075,22930652,2526.0,22325633,0,605019
9818.311396121979,22936456,2902.0,22331299,0,605157
9820.32356762886,22941866,2705.0,22336551,0,605315
9822.334404468536,22947166,2650.0,22341701,0,605465
9824.34526348114,22953108,2971.0,22347502,0,605606
9826.356655359268,22959017,2954.5,22353254,0,605763
9828.367779016495,22965241,3112.0,22359311,0,605930
9830.378639936447,22971077,2918.0,22365005,0,606072
9832.390913248062,22976786,2854.5,22370556,0,606230
9834.392192363739,22982521,2867.5,22376134,0,606387
9836.405895471573,22988513,2996.0,22381966,0,606547
9838.416600704193,22994395,2941.0,22387700,0,606695
9840.429078102112,23000447,3026.0,22393581,0,606866
9842.440087080002,23006460,3006.5,22399447,0,607013
9844.45130610466,23009633,1586.5,22402533,0,607100
9846.466257572174,23015476,2921.5,22408198,0,607278
9848.467046022415,23021613,3068.5,22414178,0,607435
9850.47769498825,23025527,1957.0,22418006,0,607521
9852.488620519638,23030819,2646.0,22423166,0,607653
9854.499376296997,23036874,3027.5,22429056,0,607818
9856.510277986526,23043173,3149.5,22435192,0,607981
9858.520946264267,23049520,3173.5,22441372,0,608148
9860.535685539246,23055578,3029.0,22447263,0,608315
9862.549250364304,23060031,2226.5,22451622,0,608409
9864.56132388115,23065573,2771.0,22456997,0,608576
9866.573170900345,23071918,3172.5,22463171,0,608747
9868.586644887924,23078101,3091.5,22469193,0,608908
9870.596926689148,23084184,3041.5,22475129,0,609055
9872.611178159714,23090379,3097.5,22481191,0,609188
9874.62360715866,23096026,2823.5,22486672,0,609354
9876.63664984703,23101822,2898.0,22492308,0,609514
9878.638994216919,23107381,2779.5,22497720,0,609661
9880.641016483307,23113588,3103.5,22503784,0,609804
9882.653478622437,23119926,3169.0,22509941,0,609985
9884.65646314621,23126099,3086.5,22515962,0,610137
9886.668683290482,23132240,3070.5,22521943,0,610297
9888.680925607681,23138343,3051.5,22527872,0,610471
9890.685373783112,23143602,2629.5,22532982,0,610620
9892.698517084122,23148673,2535.5,22537896,0,610777
9894.701998710632,23154597,2962.0,22543644,0,610953
9896.702456712723,23160749,3076.0,22549627,0,611122
9898.713739156723,23167038,3144.5,22555739,0,611299
9900.724663972855,23173270,3116.0,22561815,0,611455
9902.73693203926,23179134,2932.0,22567515,0,611619
9904.742166996002,23185172,3019.0,22573376,0,611796
9906.753647327423,23191350,3089.0,22579376,0,611974
9908.76380443573,23197626,3138.0,22585488,0,612138
9910.774757862091,23203676,3025.0,22591369,0,612307
9912.790781021118,23209841,3082.5,22597383,0,612458
9914.801248550415,23216064,3111.5,22603448,0,612616
9916.812035560608,23222355,3145.5,22609588,0,612767
9918.822652816772,23228422,3033.5,22615513,0,612909
9920.835425376892,23234585,3081.5,22621501,0,613084
9922.850472211838,23240787,3101.0,22627535,0,613252
9924.858187675476,23247043,3128.0,22633615,0,613428
9926.870337963104,23253076,3016.5,22639477,0,613599
9928.882453680038,23259224,3074.0,22645458,0,613766
9930.888167619705,23265301,3038.5,22651361,0,613940
9932.899879693985,23271298,2998.5,22657199,0,614099
9934.904357671738,23275544,2123.0,22661351,0,614193
9936.916434764862,23280494,2475.0,22666166,0,614328
9938.928759098053,23286094,2800.0,22671624,0,614470
9940.938429355621,23290276,2091.0,22675697,0,614579
9942.95073890686,23294146,1935.0,22679461,0,614685
9944.961795330048,23300304,3079.0,22685439,0,614865
9946.974853515625,23304300,1998.0,22689330,0,614970
9948.987401247025,23310242,2971.0,22695112,0,615130
9951.00293469429,23316383,3070.5,22701085,0,615298
9953.01474905014,23322234,2925.5,22706800,0,615434
9955.027612686157,23327445,2605.5,22711885,0,615560
9957.043986082077,23333287,2921.0,22717561,0,615726
9959.051973104477,23339337,3025.0,22723466,0,615871
9961.062867879868,23345105,2884.0,22729084,0,616021
9963.076189041138,23350762,2828.5,22734579,0,616183
9965.089020490646,23356357,2797.5,22740025,0,616332
9967.101195573807,23361973,2808.0,22745496,0,616477
9969.117394924164,23367614,2820.5,22750985,0,616629
9971.130533695221,23373585,2985.5,22756799,0,616786
9973.14607667923,23379472,2943.5,22762548,0,616924
9975.158172130585,23385450,2989.0,22768382,0,617068
9977.169477462769,23391142,2846.0,22773917,0,617225
9979.182219982147,23397094,2976.0,22779695,0,617399
9981.194326400757,23403059,2982.5,22785509,0,617550
9983.205030202866,23408964,2952.5,22791271,0,617693
9985.21859908104,23415045,3040.5,22797212,0,617833
9987.223652124405,23421039,2997.0,22803047,0,617992
9989.235972642899,23426964,2962.5,22808818,0,618146
9991.248342037201,23432891,2963.5,22814576,0,618315
9993.260496616364,23438592,2850.5,22820121,0,618471
9995.271661281586,23444113,2760.5,22825493,0,618620
9997.276756286621,23449982,2934.5,22831210,0,618772
9999.288477420807,23455757,2887.5,22836841,0,618916
10001.29985666275,23461568,2905.5,22842496,0,619072
10003.312354564667,23467508,2970.0,22848285,0,619223
10005.32421374321,23473819,3155.5,22854419,0,619400
10007.334736347198,23480063,3122.0,22860533,0,619530
10009.340176343918,23486224,3080.5,22866532,0,619692
10011.351114988327,23492377,3076.5,22872534,0,619843
10013.360354661942,23498555,3089.0,22878568,0,619987
10015.37258195877,23504793,3119.0,22884639,0,620154
10017.376691579819,23510697,2952.0,22890405,0,620292
10019.387834310532,23516818,3060.5,22896345,0,620473
10021.39849948883,23522927,3054.5,22902290,0,620637
10023.409676074982,23529144,3108.5,22908333,0,620811
10025.421467781067,23535178,3017.0,22914203,0,620975
10027.43322467804,23541052,2937.0,22919917,0,621135
10029.443904876709,23545536,2242.0,22924283,0,621253
10031.456108808517,23551468,2966.0,22930065,0,621403
10033.467061519623,23557367,2949.5,22935798,0,621569
10035.48020529747,23562595,2614.0,22940893,0,621702
10037.494192838669,23568143,2774.0,22946295,0,621848
10039.506257295609,23571953,1905.0,22950006,0,621947
10041.51443195343,23577943,2995.0,22955815,0,622128
10043.526096343994,23584109,3083.0,22961822,0,622287
10045.537075042725,23587375,1633.0,22965004,0,622371
10047.548443078995,23590414,1519.5,22967962,0,622452
10049.560136795044,23595145,2365.5,22972582,0,622563
10051.565434455872,23601188,3021.5,22978475,0,622713
10053.578353881836,23607323,3067.5,22984448,0,622875
10055.583302021027,23612903,2790.0,22989894,0,623009
10057.597853422165,23618426,2761.5,22995277,0,623149
10059.602133750916,23623195,2384.5,22999924,0,623271
10061.611504554749,23628862,2833.5,23005434,0,623428
10063.612220525742,23633551,2344.5,23010002,0,623549
10065.625517606735,23639000,2724.5,23015313,0,623687
10067.636498451233,23644923,2961.5,23021083,0,623840
10069.642690181732,23650075,2576.0,23026120,0,623955
10071.659332990646,23653867,1896.0,23029811,0,624056
10073.670267105103,23660149,3141.0,23035915,0,624234
10075.686454057693,23664541,2196.0,23040172,0,624369
10077.700848340988,23670245,2852.0,23045745,0,624500
10079.70202922821,23676127,2941.0,23051468,0,624659
10081.71287369728,23682158,3015.5,23057325,0,624833
10083.723346471786,23688312,3077.0,23063325,0,624987
10085.733951330185,23694149,2918.5,23068995,0,625154
10087.74451637268,23700077,2964.0,23074762,0,625315
10089.754942417145,23704582,2252.5,23079148,0,625434
10091.765383005142,23710482,2950.0,23084896,0,625586
10093.770995855331,23716811,3164.5,23091075,0,625736
10095.781486988068,23722957,3073.0,23097048,0,625909
10097.788095235825,23729134,3088.5,23103050,0,626084
10099.800710201263,23735332,3099.0,23109095,0,626237
10101.801942110062,23741368,3018.0,23114969,0,626399
10103.818023443222,23747620,3126.0,23121066,0,626554
10105.829332828522,23753882,3131.0,23127168,0,626714
10107.841504573822,23760047,3082.5,23133162,0,626885
10109.852086544037,23766080,3016.5,23139040,0,627040
10111.865622520447,23772270,3095.0,23145077,0,627193
10113.880459070206,23778370,3050.0,23151018,0,627352
10115.890023231506,23784331,2980.5,23156830,0,627501
10117.903375148773,23790354,3011.5,23162689,0,627665
10119.915306091309,23796515,3080.5,23168697,0,627818
10121.915476083755,23802723,3104.0,23174740,0,627983
10123.927987575531,23808934,3105.5,23180801,0,628133
10125.935891628265,23814637,2851.5,23186343,0,628294
10127.93868970871,23820626,2994.5,23192169,0,628457
10129.953414916992,23826564,2969.0,23197943,0,628621
10131.967319726944,23832474,2955.0,23203712,0,628762
10133.977994918823,23837448,2487.0,23208568,0,628880
10135.98907828331,23841391,1971.5,23212413,0,628978
10138.002531528473,23847653,3131.0,23218515,0,629138
10140.0134267807,23853757,3052.0,23224453,0,629304
10142.024586200714,23859871,3057.0,23230405,0,629466
10144.024839401245,23865979,3054.0,23236336,0,629643
10146.0381026268,23872149,3085.0,23242352,0,629797
10148.053971290588,23878273,3062.0,23248317,0,629956
10150.061774492264,23884385,3056.0,23254265,0,630120
10152.07256770134,23890610,3112.5,23260310,0,630300
10154.083368301392,23896091,2740.5,23265637,0,630454
10156.09080171585,23902297,3103.0,23271683,0,630614
10158.102517843246,23908251,2977.0,23277479,0,630772
10160.113298416138,23914293,3021.0,23283350,0,630943
10162.129557132721,23920156,2931.5,23289050,0,631106
10164.141862154007,23926036,2940.0,23294767,0,631269
10166.157338619232,23931823,2893.5,23300410,0,631413
10168.17131280899,23937946,3061.5,23306378,0,631568
10170.1864361763,23941308,1681.0,23309652,0,631656
10172.19741845131,23945153,1922.5,23313395,0,631758
10174.208418607712,23949547,2197.0,23317667,0,631880
10176.214515686035,23955444,2948.5,23323401,0,632043
10178.225165605545,23961348,2952.0,23329154,0,632194
10180.238242149353,23967383,3017.5,23335036,0,632347
10182.252338886261,23973402,3009.5,23340894,0,632508
10184.265345096588,23977596,2097.0,23344969,0,632627
10186.268430948257,23983767,3085.5,23350977,0,632790
10188.27342915535,23989792,3012.5,23356829,0,632963
10190.286294698715,23995879,3043.5,23362735,0,633144
10192.297771692276,24002081,3101.0,23368771,0,633310
10194.309568166733,24008397,3158.0,23374927,0,633470
10196.316110372543,24014406,3004.5,23380770,0,633636
10198.327484369278,24020467,3030.5,23386677,0,633790
10200.339876413345,24026556,3044.5,23392605,0,633951
10202.353209733963,24032710,3077.0,23398600,0,634110
10204.367207050323,24038928,3109.0,23404649,0,634279
10206.3717918396,24044977,3024.5,23410542,0,634435
10208.382398605347,24051216,3119.5,23416614,0,634602
10210.395424127579,24057534,3159.0,23422768,0,634766
10212.40814089775,24063762,3114.0,23428810,0,634952
10214.409696340561,24069905,3071.5,23434798,0,635107
10216.42154097557,24076047,3071.0,23440790,0,635257
10218.432856321335,24082221,3087.0,23446796,0,635425
10220.446249485016,24086824,2301.5,23451267,0,635557
10222.459183454514,24092967,3071.5,23457268,0,635699
10224.471411705017,24098838,2935.5,23462974,0,635864
10226.472702980042,24104556,2859.0,23468533,0,636023
10228.48317861557,24110479,2961.5,23474305,0,636174
10230.493990182877,24116272,2896.5,23479960,0,636312
10232.506783485413,24122319,3023.5,23485879,0,636440
10234.521307706833,24128241,2961.0,23491639,0,636602
10236.529664039612,24134244,3001.5,23497498,0,636746
10238.54103922844,24140377,3066.5,23503473,0,636904
10240.5511033535,24146536,3079.5,23509477,0,637059
10242.561729192734,24152753,3108.5,23515545,0,637208
10244.57269859314,24159072,3159.5,23521687,0,637385
10246.583468914032,24165324,3126.0,23527794,0,637530
10248.59416103363,24171493,3084.5,23533807,0,637686
10250.604877471924,24177652,3079.5,23539804,0,637848
10252.615624427795,24184064,3206.0,23546051,0,638013
10254.621102571487,24190146,3041.0,23551977,0,638169
10256.6329267025,24196145,2999.5,23557817,0,638328
10258.646287679672,24202386,3120.5,23563912,0,638474
10260.66123509407,24208632,3123.0,23569988,0,638644
10262.67372059822,24214821,3094.5,23576011,0,638810
10264.684658527374,24220904,3041.5,23581935,0,638969
10266.695279598236,24227094,3095.0,23587956,0,639138
10268.70839381218,24233440,3173.0,23594133,0,639307
10270.717815160751,24239608,3084.0,23600135,0,639473
10272.72831749916,24245795,3093.5,23606168,0,639627
10274.74079990387,24252047,3126.0,23612268,0,639779
10276.754872560501,24255736,1844.5,23615869,0,639867
10278.767706155777,24261164,2714.0,23621151,0,640013
10280.779651403427,24267242,3039.0,23627050,0,640192
10282.79333281517,24271177,1967.5,23630860,0,640317
10284.806021690369,24277238,3030.5,23636762,0,640476
10286.81679558754,24281532,2147.0,23640948,0,640584
10288.83024430275,24285425,1946.5,23644725,0,640700
10290.840804338455,24290866,2720.5,23650017,0,640849
10292.852269411087,24296698,2916.0,23655693,0,641005
10294.863917589188,24302363,2832.5,23661216,0,641147
10296.875509262085,24307251,2444.0,23665981,0,641270
10298.882999658585,24313092,2920.5,23671658,0,641434
10300.889100790024,24319196,3052.0,23677609,0,641587
10302.894120931625,24325192,2998.0,23683450,0,641742
10304.905197143555,24330972,2890.0,23689101,0,641871
10306.913217067719,24337280,3154.0,23695253,0,642027
10308.913534879684,24343147,2933.5,23700955,0,642192
10310.922642707825,24349154,3003.5,23706810,0,642344
10312.928657531738,24355318,3082.0,23712833,0,642485
10314.92920923233,24361459,3070.5,23718811,0,642648
10316.934865236282,24367228,2884.5,23724428,0,642800
10318.935309410095,24373053,2912.5,23730119,0,642934
10320.935507297516,24379177,3062.0,23736077,0,643100
10322.940494537354,24385135,2979.0,23741873,0,643262
10324.940497875214,24389336,2100.5,23745976,0,643360
10326.95612502098,24395298,2981.0,23751762,0,643536
10328.971746444702,24401278,2990.0,23757576,0,643702
10330.972143173218,24406857,2789.5,23763001,0,643856
10332.973391771317,24412577,2860.0,23768572,0,644005
10334.989018678665,24418678,3050.5,23774522,0,644156
10336.989043712616,24424558,2940.0,23780235,0,644323
10338.989928245544,24430743,3092.5,23786259,0,644484
10340.989945411682,24436775,3016.0,23792120,0,644655
10342.991109609604,24441605,2415.0,23796815,0,644790
10344.99521613121,24444736,1565.5,23799873,0,644863
10347.001808166504,24450567,2915.5,23805569,0,644998
10349.017403125763,24456335,2884.0,23811188,0,645147
10351.0174036026,24460805,2235.0,23815535,0,645270
10353.019219875336,24466612,2903.5,23821209,0,645403
10355.020577907562,24472209,2798.5,23826669,0,645540
10357.036221981049,24478467,3129.0,23832752,0,645715
10359.051827669144,24484710,3121.5,23838849,0,645861
10361.054026842117,24490807,3048.5,23844794,0,646013
10363.055169582367,24494882,2037.5,23848766,0,646116
10365.05710697174,24500347,2732.5,23854081,0,646266
10367.062609672546,24506643,3148.0,23860217,0,646426
10369.06285071373,24512628,2992.5,23866059,0,646569
10371.065101861954,24518739,3055.5,23872021,0,646718
10373.067373991013,24524378,2819.5,23877515,0,646863
10375.082970619202,24530457,3039.5,23883433,0,647024
10377.08442234993,24536543,3043.0,23889339,0,647204
10379.085683107376,24542278,2867.5,23894950,0,647328
10381.085684299469,24546404,2063.0,23898977,0,647427
10383.08671426773,24551802,2699.0,23904240,0,647562
10385.086720943451,24557623,2910.5,23909913,0,647710
10387.098587751389,24563316,2846.5,23915454,0,647862
10389.099792957306,24567486,2085.0,23919502,0,647984
10391.101370573044,24573504,3009.0,23925360,0,648144
10393.102421045303,24579245,2870.5,23930969,0,648276
10395.102540016174,24585241,2998.0,23936818,0,648423
10397.103593111038,24591259,3009.0,23942687,0,648572
10399.10385107994,24597131,2936.0,23948394,0,648737
10401.11631155014,24603392,3130.5,23954513,0,648879
10403.130177736282,24609359,2983.5,23960314,0,649045
10405.131179571152,24613223,1932.0,23964085,0,649138
10407.131983757019,24619031,2904.0,23969748,0,649283
10409.137418746948,24624793,2881.0,23975355,0,649438
10411.153019428253,24630521,2864.0,23980930,0,649591
10413.168644189835,24636702,3090.5,23986966,0,649736
10415.170455694199,24642321,2809.5,23992439,0,649882
10417.177819728851,24648439,3059.0,23998403,0,650036
10419.187893390656,24653563,2562.0,24003400,0,650163
10421.193413257599,24659612,3024.5,24009277,0,650335
10423.194106578827,24665752,3070.0,24015264,0,650488
10425.194227933884,24671928,3088.0,24021283,0,650645
10427.194358825684,24678075,3073.5,24027273,0,650802
10429.200057029724,24683292,2608.5,24032365,0,650927
10431.215532302856,24689119,2913.5,24038033,0,651086
10433.222632169724,24695297,3089.0,24044039,0,651258
10435.222651720047,24700631,2667.0,24049230,0,651401
10437.228590726852,24706824,3096.5,24055253,0,651571
10439.230054140091,24713095,3135.5,24061371,0,651724
10441.230054855347,24719366,3135.5,24067488,0,651878
10443.230144023895,24724348,2491.0,24072345,0,652003
10445.231338739395,24730007,2829.5,24077862,0,652145
10447.246939659119,24736246,3119.5,24083923,0,652323
10449.247601747513,24742223,2988.5,24089738,0,652485
10451.247622966766,24747697,2737.0,24095065,0,652632
10453.248022079468,24753635,2969.0,24100846,0,652789
10455.248845100403,24759797,3081.0,24106843,0,652954
10457.248910665512,24766119,3161.0,24112992,0,653127
10459.262590885162,24771276,2578.5,24118019,0,653257
10461.263091564178,24777263,2993.5,24123849,0,653414
10463.278700113297,24783484,3110.5,24129891,0,653593
10465.279346466064,24789442,2979.0,24135697,0,653745
10467.279346466064,24795594,3076.0,24141692,0,653902
10469.282573223114,24801637,3021.5,24147603,0,654034
10471.285975694656,24807803,3083.0,24153594,0,654209
10473.286851406097,24814020,3108.5,24159643,0,654377
10475.294836759567,24818283,2131.5,24163794,0,654489
10477.3036506176,24822820,2268.5,24168203,0,654617
10479.304104328156,24828637,2908.5,24173871,0,654766
10481.315945386887,24834736,3049.5,24179795,0,654941
10483.330025672913,24839081,2172.5,24184041,0,655040
10485.343073368073,24842998,1958.5,24187868,0,655130
10487.356709003448,24848460,2731.0,24193196,0,655264
10489.36683678627,24851658,1599.0,24196334,0,655324
10491.366854429245,24856165,2253.5,24200731,0,655434
10493.379982948303,24862126,2980.5,24206531,0,655595
10495.38203406334,24868109,2991.5,24212366,0,655743
10497.384967327118,24873954,2922.5,24218031,0,655923
10499.39586520195,24879428,2737.0,24223360,0,656068
10501.408735752106,24885566,3069.0,24229334,0,656232
10503.424339532852,24891796,3115.0,24235394,0,656402
10505.435131549835,24897715,2959.5,24241164,0,656551
10507.435131788254,24903647,2966.0,24246938,0,656709
10509.45075583458,24909890,3121.5,24253020,0,656870
10511.45097208023,24916187,3148.5,24259158,0,657029
10513.453880786896,24922326,3069.5,24265137,0,657189
10515.456401348114,24928415,3044.5,24271079,0,657336
10517.471993923187,24934419,3002.0,24276916,0,657503
10519.472357273102,24938930,2255.5,24281315,0,657615
10521.482803583145,24944278,2674.0,24286523,0,657755
10523.49844789505,24950424,3073.0,24292524,0,657900
10525.51405286789,24956302,2939.0,24298259,0,658043
10527.514053583145,24962103,2900.5,24303925,0,658178
10529.520843744278,24968211,3054.0,24309881,0,658330
10531.522280931473,24974036,2912.5,24315554,0,658482
10533.522282361984,24980059,3011.5,24321423,0,658636
10535.52672123909,24985338,2639.5,24326560,0,658778
10537.527821302414,24991475,3068.5,24332525,0,658950
10539.527849435806,24997445,2985.0,24338345,0,659100
10541.528293848038,25002625,2590.0,24343401,0,659224
10543.528404712677,25006142,1758.5,24346843,0,659299
10545.543938398361,25010114,1986.0,24350720,0,659394
10547.543939113617,25016366,3126.0,24356806,0,659560
10549.555303812027,25020224,1929.0,24360568,0,659656
10551.555947065353,25026254,3015.0,24366430,0,659824
10553.556067705154,25031797,2771.5,24371832,0,659965
10555.57153916359,25036657,2430.0,24376580,0,660077
10557.584025859833,25041872,2607.5,24381667,0,660205
10559.599639415741,25046899,2513.5,24386573,0,660326
10561.611775875092,25053056,3078.5,24392565,0,660491
10563.612423181534,25058961,2952.5,24398301,0,660660
10565.622561454773,25064882,2960.5,24404046,0,660836
10567.631427288055,25070302,2710.0,24409315,0,660987
10569.639573335648,25076442,3070.0,24415301,0,661141
10571.63957452774,25082609,3083.5,24421296,0,661313
10573.642597436905,25088290,2840.5,24426848,0,661442
10575.658222198486,25094559,3134.5,24432957,0,661602
10577.668241977692,25100864,3152.5,24439100,0,661764
10579.683867692947,25107000,3068.0,24445079,0,661921
10581.689054012299,25112252,2626.0,24450208,0,662044
10583.691074371338,25116003,1875.5,24453859,0,662144
10585.692378759384,25122158,3077.5,24459843,0,662315
10587.706516742706,25128430,3136.0,24465953,0,662477
10589.721088647842,25134511,3040.5,24471883,0,662628
10591.736713171005,25140831,3160.0,24478050,0,662781
10593.739919424057,25147131,3150.0,24484198,0,662933
10595.742112874985,25152904,2886.5,24489824,0,663080
10597.75064945221,25158866,2981.0,24495648,0,663218
10599.751022577286,25165021,3077.5,24501630,0,663391
10601.756760835648,25171354,3166.5,24507801,0,663553
10603.760343074799,25177350,2998.0,24513642,0,663708
10605.772641420364,25183531,3090.5,24519674,0,663857
10607.784697294235,25189781,3125.0,24525757,0,664024
10609.792289733887,25195970,3094.5,24531800,0,664170
10611.799448728561,25202153,3091.5,24537825,0,664328
10613.814087152481,25208261,3054.0,24543783,0,664478
10615.81985783577,25214522,3130.5,24549898,0,664624
10617.819987773895,25220864,3171.0,24556071,0,664793
10619.82652759552,25226935,3035.5,24561993,0,664942
10621.826528549194,25233131,3098.0,24568051,0,665080
10623.836458206177,25239181,3025.0,24573944,0,665237
10625.852204084396,25245368,3093.5,24579969,0,665399
10627.85374546051,25251269,2950.5,24585714,0,665555
10629.85418510437,25257099,2915.0,24591380,0,665719
10631.863285779953,25263007,2954.0,24597124,0,665883
10633.878909349442,25269127,3060.0,24603092,0,666035
10635.878909349442,25275208,3040.5,24609018,0,666190
10637.887387752533,25280943,2867.5,24614603,0,666340
10639.899359703064,25287037,3047.0,24620525,0,666512
10641.91498708725,25293378,3170.5,24626697,0,666681
10643.930588722229,25299522,3072.0,24632675,0,666847
10645.932671785355,25305595,3036.5,24638592,0,667003
10647.935486078262,25311684,3044.5,24644499,0,667185
10649.939368486404,25317702,3009.0,24650334,0,667368
10651.953700065613,25323855,3076.5,24656328,0,667527
10653.957437515259,25329649,2897.0,24661982,0,667667
10655.957805395126,25334851,2601.0,24667053,0,667798
10657.973428726196,25338915,2032.0,24671008,0,667907
10659.973861217499,25344838,2961.5,24676778,0,668060
10661.978473901749,25350803,2982.5,24682563,0,668240
10663.978473901749,25356487,2842.0,24688090,0,668397
10665.979974269867,25361573,2543.0,24693054,0,668519
10667.99194264412,25367170,2798.5,24698502,0,668668
10670.005713939667,25372863,2846.5,24704046,0,668817
10672.013972997665,25377635,2386.0,24708702,0,668933
10674.01418209076,25380445,1405.0,24711422,0,669023
10676.025658845901,25386023,2789.0,24716850,0,669173
10678.025681495667,25391967,2972.0,24722617,0,669350
10680.041286230087,25398141,3087.0,24728631,0,669510
10682.041398763657,25401788,1823.5,24732193,0,669595
10684.052434444427,25404644,1428.0,24734985,0,669659
10686.06793665886,25408507,1931.5,24738736,0,669771
10688.083578586578,25413929,2711.0,24744047,0,669882
10690.09917473793,25419925,2998.0,24749894,0,670031
10692.100784540176,25425972,3023.5,24755781,0,670191
10694.106623649597,25431907,2967.5,24761550,0,670357
10696.114564657211,25437972,3032.5,24767466,0,670506
10698.117701292038,25443956,2992.0,24773291,0,670665
10700.121287822723,25449942,2993.0,24779122,0,670820
10702.12128829956,25455912,2985.0,24784917,0,670995
10704.121909856796,25461636,2862.0,24790479,0,671157
10706.137312412262,25467426,2895.0,24796126,0,671300
10708.139156579971,25473273,2923.5,24801841,0,671432
10710.154037714005,25479335,3031.0,24807721,0,671614
10712.157564878464,25485187,2926.0,24813430,0,671757
10714.158942699432,25490778,2795.5,24818876,0,671902
10716.174448251724,25496649,2935.5,24824600,0,672049
10718.190074920654,25502498,2924.5,24830301,0,672197
10720.202626943588,25508567,3034.5,24836192,0,672375
10722.216680049896,25514707,3070.0,24842146,0,672561
10724.216680288315,25520956,3124.5,24848216,0,672740
10726.232304811478,25527250,3147.0,24854367,0,672883
10728.247951984406,25531560,2155.0,24858572,0,672988
10730.262518644333,25536648,2544.0,24863539,0,673109
10732.278021097183,25540778,2065.0,24867569,0,673209
10734.284745693207,25545953,2587.5,24872600,0,673353
10736.284757375717,25552092,3069.5,24878578,0,673514
10738.2856194973,25558173,3040.5,24884507,0,673666
10740.288721561432,25564293,3060.0,24890474,0,673819
10742.297654151917,25567964,1835.5,24894055,0,673909
10744.298575878143,25571646,1841.0,24897642,0,674004
10746.303374767303,25577719,3036.5,24903566,0,674153
10748.31900191307,25583937,3109.0,24909614,0,674323
10750.3204703331,25590077,3070.0,24915597,0,674480
10752.3360953331,25596122,3022.5,24921479,0,674643
10754.347761154175,25602086,2982.0,24927289,0,674797
10756.351791143417,25606083,1998.5,24931186,0,674897
10758.353857040405,25611959,2938.0,24936903,0,675056
10760.354612588882,25617815,2928.0,24942588,0,675227
10762.354773283005,25623868,3026.5,24948470,0,675398
10764.370376110077,25629641,2886.5,24954086,0,675555
10766.371252536774,25635582,2970.5,24959874,0,675708
10768.372123479843,25641619,3018.5,24965773,0,675846
10770.375268936157,25647400,2890.5,24971427,0,675973
10772.376035928726,25653192,2896.0,24977070,0,676122
10774.382098674774,25659019,2913.5,24982747,0,676272
10776.382318973541,25665231,3106.0,24988790,0,676441
10778.391192436218,25671305,3037.0,24994714,0,676591
10780.393846988678,25675377,2036.0,24998689,0,676688
10782.394101858139,25681427,3025.0,25004572,0,676855
10784.409725189209,25687712,3142.5,25010677,0,677035
10786.418462753296,25692466,2377.0,25015307,0,677159
10788.427662611008,25696658,2096.0,25019391,0,677267
10790.440544605255,25701692,2517.0,25024309,0,677383
10792.456136703491,25708094,3201.0,25030530,0,677564
10794.466450452805,25714210,3058.0,25036482,0,677728
10796.482052326202,25720180,2985.0,25042323,0,677857
10798.483660459518,25726178,2999.0,25048189,0,677989
10800.488671302795,25732247,3034.5,25054097,0,678150
10802.488678216934,25738398,3075.5,25060092,0,678306
10804.49908542633,25744626,3114.0,25066168,0,678458
10806.509008169174,25750739,3056.5,25072130,0,678609
10808.514006376266,25756831,3046.0,25078066,0,678765
10810.517143964767,25763011,3090.0,25084096,0,678915
10812.517169713974,25769088,3038.5,25089995,0,679093
10814.532909870148,25775266,3089.0,25096001,0,679265
10816.539120435715,25781557,3145.5,25102129,0,679428
10818.547633886337,25786912,2677.5,25107345,0,679567
10820.553741455078,25791182,2135.0,25111516,0,679666
10822.556164741516,25796883,2850.5,25117077,0,679806
10824.560642957687,25802200,2658.5,25122260,0,679940
10826.563616991043,25808442,3121.0,25128339,0,680103
10828.563731908798,25814508,3033.0,25134252,0,680256
10830.570088148117,25820619,3055.5,25140221,0,680398
10832.579415798187,25826747,3064.0,25146195,0,680552
10834.587200403214,25832603,2928.0,25151885,0,680718
10836.594812393188,25838415,2906.0,25157528,0,680887
10838.610433101654,25844696,3140.5,25163653,0,681043
10840.611434698105,25850882,3093.0,25169666,0,681216
10842.612548589706,25857042,3080.0,25175659,0,681383
10844.619049072266,25862998,2978.0,25181449,0,681549
10846.621281385422,25869120,3061.0,25187413,0,681707
10848.62151479721,25875278,3079.0,25193411,0,681867
10850.621603012085,25880670,2696.0,25198648,0,682022
10852.622546434402,25883738,1534.0,25201623,0,682115
10854.638163089752,25888341,2301.5,25206104,0,682237
10856.63947224617,25893344,2501.5,25210965,0,682379
10858.641162395477,25899568,3112.0,25217016,0,682552
10860.644414663315,25905539,2985.5,25222820,0,682719
10862.656425237656,25911733,3097.0,25228872,0,682861
10864.672050476074,25918066,3166.5,25235025,0,683041
10866.672050476074,25924302,3118.0,25241085,0,683217
10868.681134700775,25930434,3066.0,25247054,0,683380
10870.682416439056,25936345,2955.5,25252819,0,683526
10872.682446956635,25942586,3120.5,25258881,0,683705
10874.692999362946,25948705,3059.5,25264840,0,683865
10876.703502178192,25954741,3018.0,25270722,0,684019
10878.714118242264,25960930,3094.5,25276755,0,684175
10880.72862315178,25964758,1914.0,25280478,0,684280
10882.728646039963,25970643,2942.5,25286170,0,684473
10884.728752613068,25976828,3092.5,25292208,0,684620
10886.729729890823,25983054,3113.0,25298259,0,684795
10888.730719089508,25989050,2998.0,25304090,0,684960
10890.73192358017,25995258,3104.0,25310143,0,685115
10892.738733530045,26001373,3057.5,25316098,0,685275
10894.741286277771,26006932,2779.5,25321494,0,685438
10896.742666959763,26012693,2880.5,25327104,0,685589
10898.753183364868,26018839,3073.0,25333113,0,685726
10900.768206119537,26024784,2972.5,25338896,0,685888
10902.768466472626,26030949,3082.5,25344906,0,686043
10904.768544912338,26037169,3110.0,25350956,0,686213
10906.769567966461,26043282,3056.5,25356910,0,686372
10908.774285316467,26049380,3049.0,25362844,0,686536
10910.776871919632,26055550,3085.0,25368851,0,686699
10912.79250741005,26061995,3222.5,25375125,0,686870
10914.79418683052,26068000,3002.5,25380975,0,687025
10916.79423546791,26074007,3003.5,25386830,0,687177
10918.809839487076,26080297,3145.0,25392952,0,687345
10920.82548546791,26086428,3065.5,25398907,0,687521
10922.838239908218,26092447,3009.5,25404773,0,687674
10924.85384941101,26098547,3050.0,25410726,0,687821
10926.858459711075,26104533,2993.0,25416564,0,687969
10928.858459711075,26110850,3158.5,25422723,0,688127
10930.858612060547,26116723,2936.5,25428458,0,688265
10932.86420583725,26122255,2766.0,25433850,0,688405
10934.867030858994,26128008,2876.5,25439442,0,688566
10936.871893167496,26133879,2935.5,25445162,0,688717
10938.89219737053,26139758,2939.5,25450894,0,688864
10940.902052640915,26143586,1914.0,25454631,0,688955
10942.908212423325,26149585,2999.5,25460455,0,689130
10944.908710241318,26155746,3080.5,25466464,0,689282
10946.908712148666,26159544,1899.0,25470178,0,689366
10948.908732175827,26164807,2631.5,25475310,0,689497
10950.914854764938,26170620,2906.5,25480981,0,689639
10952.930407524109,26176743,3061.5,25486940,0,689803
10954.932341575623,26181760,2508.5,25491829,0,689931
10956.943979978561,26186139,2189.5,25496105,0,690034
10958.94405245781,26190412,2136.5,25500261,0,690151
10960.945347309113,26195906,2747.0,25505619,0,690287
10962.95567703247,26201830,2962.0,25511403,0,690427
10964.95850110054,26208003,3086.5,25517416,0,690587
10966.958515882492,26214116,3056.5,25523361,0,690755
10968.958761692047,26220196,3040.0,25529292,0,690904
10970.974403858185,26226478,3141.0,25535422,0,691056
10972.980101108551,26232498,3010.0,25541281,0,691217
10974.980484724045,26238700,3101.0,25547332,0,691368
10976.99545621872,26244906,3103.0,25553370,0,691536
10979.01108121872,26251100,3097.0,25559426,0,691674
10981.011081695557,26257187,3043.5,25565359,0,691828
10983.012186288834,26263325,3069.0,25571335,0,691990
10985.012311458588,26268934,2804.5,25576804,0,692130
10987.016937494278,26273522,2294.0,25581284,0,692238
10989.026661396027,26279208,2843.0,25586817,0,692391
10991.032622337341,26285179,2985.5,25592635,0,692544
10993.048246383667,26291056,2938.5,25598331,0,692725
10995.05253648758,26296759,2851.5,25603874,0,692885
10997.06172132492,26302668,2954.5,25609647,0,693021
10999.06337594986,26308527,2929.5,25615351,0,693176
11001.0633893013,26312727,2100.0,25619464,0,693263
11003.079018831253,26318379,2826.0,25624979,0,693400
11005.094645738602,26324247,2934.0,25630696,0,693551
11007.095234155655,26329716,2734.5,25636010,0,693706
11009.095420360565,26332703,1493.5,25638917,0,693786
11011.111018896103,26337494,2395.5,25643579,0,693915
11013.112741231918,26343434,2970.0,25649351,0,694083
11015.112741947174,26349126,2846.0,25654894,0,694232
11017.120332717896,26355096,2985.0,25660687,0,694409
11019.120332717896,26360907,2905.5,25666357,0,694550
11021.120636463165,26366801,2947.0,25672086,0,694715
11023.120745420456,26372700,2949.5,25677837,0,694863
11025.136247634888,26378791,3045.5,25683752,0,695039
11027.151886463165,26384850,3029.5,25689629,0,695221
11029.15620470047,26391049,3099.5,25695682,0,695367
11031.156701803207,26397228,3089.5,25701697,0,695531
11033.156725406647,26403305,3038.5,25707597,0,695708
11035.172326087952,26409439,3067.0,25713557,0,695882
11037.178076267242,26415541,3051.0,25719473,0,696068
11039.193701267242,26421853,3156.0,25725625,0,696228
11041.208788871765,26427904,3025.5,25731514,0,696390
11043.219516038895,26433807,2951.5,25737265,0,696542
11045.224353790283,26439931,3062.0,25743238,0,696693
11047.22436285019,26446173,3121.0,25749322,0,696851
11049.239977836609,26452335,3081.0,25755319,0,697016
11051.252962827682,26458481,3073.0,25761299,0,697182
11053.268587112427,26464722,3120.5,25767385,0,697337
11055.284228563309,26470888,3083.0,25773384,0,697504
11057.296519517899,26477000,3056.0,25779346,0,697654
11059.303139686584,26483024,3012.0,25785218,0,697806
11061.303139925003,26489125,3050.5,25791142,0,697983
11063.318764448166,26495492,3183.5,25797333,0,698159
11065.318766832352,26501745,3126.5,25803413,0,698332
11067.326866149902,26507754,3004.5,25809263,0,698491
11069.331374406815,26513684,2965.0,25815045,0,698639
11071.347002506256,26519903,3109.5,25821092,0,698811
11073.348536491394,26526183,3140.0,25827197,0,698986
11075.348537445068,26531909,2863.0,25832781,0,699128
11077.3558883667,26538038,3064.5,25838762,0,699276
11079.356341600418,26544247,3104.5,25844828,0,699419
11081.35813331604,26550333,3043.0,25850759,0,699574
11083.369124650955,26556446,3056.5,25856704,0,699742
11085.38324022293,26562608,3081.0,25862687,0,699921
11087.387318372726,26568840,3116.0,25868761,0,700079
11089.388717889786,26575180,3170.0,25874948,0,700232
11091.396928787231,26581248,3034.0,25880857,0,700391
11093.39692902565,26587436,3094.0,25886875,0,700561
11095.412554740906,26593648,3106.0,25892923,0,700725
11097.42610836029,26599695,3023.5,25898818,0,700877
11099.428091049194,26605777,3041.0,25904731,0,701046
11101.428456783295,26611988,3105.5,25910791,0,701197
11103.429290294647,26618323,3167.5,25916941,0,701382
11105.44470500946,26624346,3011.5,25922799,0,701547
11107.445759296417,26630569,3111.5,25928847,0,701722
11109.446455717087,26636571,3001.0,25934678,0,701893
11111.447113513947,26642751,3090.0,25940711,0,702040
11113.448942899704,26648781,3015.0,25946575,0,702206
11115.455187559128,26654941,3080.0,25952563,0,702378
11117.470793247223,26661246,3152.5,25958724,0,702522
11119.470810174942,26667252,3003.0,25964588,0,702664
11121.478020906448,26673246,2997.0,25970421,0,702825
11123.49355173111,26676698,1726.0,25973789,0,702909
11125.494934797287,26682500,2901.0,25979429,0,703071
11127.49551153183,26688683,3091.5,25985434,0,703249
11129.511109828949,26694797,3057.0,25991371,0,703426
11131.51200389862,26701042,3122.5,25997445,0,703597
11133.513042211533,26707285,3121.5,26003518,0,703767
11135.516418218613,26711465,2090.0,26007592,0,703873
11137.532034873962,26717245,2890.0,26013208,0,704037
11139.533457756042,26723355,3055.0,26019161,0,704194
11141.53433060646,26729611,3128.0,26025242,0,704369
11143.53593301773,26735784,3086.5,26031226,0,704558
11145.543219804764,26741859,3037.5,26037142,0,704717
11147.558824777603,26746021,2081.0,26041188,0,704833
11149.559118747711,26751956,2967.5,26046958,0,704998
11151.574741125107,26758187,3115.5,26053023,0,705164
11153.58769249916,26764301,3057.0,26058979,0,705322
11155.588988304138,26770551,3125.0,26065046,0,705505
11157.588994026184,26775003,2226.0,26069394,0,705609
11159.601301193237,26780560,2778.5,26074806,0,705754
11161.60191655159,26786722,3081.0,26080824,0,705898
11163.602625370026,26791271,2274.5,26085255,0,706016
11165.616922616959,26796866,2797.5,26090701,0,706165
11167.63254570961,26803014,3074.0,26096672,0,706342
11169.648170948029,26809034,3010.0,26102524,0,706510
11171.6481924057,26815263,3114.5,26108586,0,706677
11173.650527715683,26821527,3132.0,26114682,0,706845
11175.652500629425,26824443,1458.0,26117524,0,706919
11177.653406858444,26828430,1993.5,26121418,0,707012
11179.661850214005,26832231,1900.5,26125124,0,707107
11181.667098522186,26836124,1946.5,26128918,0,707206
11183.667221307755,26841831,2853.5,26134472,0,707359
11185.682841062546,26844722,1445.5,26137291,0,707431
11187.698348760605,26850214,2746.0,26142618,0,707596
11189.699524402618,26856166,2976.0,26148391,0,707775
11191.704689741135,26862141,2987.5,26154210,0,707931
11193.706963777542,26868074,2966.5,26159973,0,708101
11195.71767950058,26873728,2827.0,26165491,0,708237
11197.718389511108,26879782,3027.0,26171390,0,708392
11199.72924399376,26885648,2933.0,26177104,0,708544
11201.738401174545,26891480,2916.0,26182793,0,708687
11203.739041090012,26895612,2066.0,26186812,0,708800
11205.741795063019,26901121,2754.5,26192163,0,708958
11207.755574941635,26907281,3080.0,26198174,0,709107
11209.757915973663,26912844,2781.5,26203595,0,709249
11211.759860992432,26918861,3008.5,26209449,0,709412
11213.765744686127,26924445,2792.0,26214902,0,709543
11215.777861118317,26930493,3024.0,26220791,0,709702
11217.785742044449,26935192,2349.5,26225360,0,709832
11219.792286634445,26940912,2860.0,26230905,0,710007
11221.80338358879,26946583,2835.5,26236404,0,710179
11223.81437087059,26951611,2514.0,26241302,0,710309
11225.824840545654,26957231,2810.0,26246767,0,710464
11227.836176395416,26961180,1974.5,26250607,0,710573
11229.846669197083,26967159,2989.5,26256434,0,710725
11231.856084108353,26972887,2864.0,26261999,0,710888
11233.86702799797,26978820,2966.5,26267782,0,711038
11235.878688097,26983933,2556.5,26272751,0,711182
11237.889833688736,26989032,2549.5,26277712,0,711320
11239.900985002518,26994611,2789.5,26283159,0,711452
11241.912427663803,27000865,3127.0,26289264,0,711601
11243.926205396652,27007216,3175.5,26295449,0,711767
11245.937038898468,27013426,3105.0,26301499,0,711927
11247.949080944061,27019588,3081.0,26307484,0,712104
11249.96242594719,27025712,3062.0,26313450,0,712262
11251.973917245865,27031881,3084.5,26319456,0,712425
11253.98898100853,27037765,2942.0,26325200,0,712565
11255.999729633331,27043539,2887.0,26330825,0,712714
11258.010761260986,27049756,3108.5,26336876,0,712880
11260.02159667015,27055952,3098.0,26342894,0,713058
11262.032252311707,27062104,3076.0,26348903,0,713201
11264.034343004227,27068362,3129.0,26354988,0,713374
11266.045094966888,27074691,3164.5,26361171,0,713520
11268.05616903305,27080863,3086.0,26367177,0,713686
11270.057563781738,27087027,3082.0,26373191,0,713836
11272.068453073502,27093266,3119.5,26379282,0,713984
11274.080181121826,27099030,2882.0,26384898,0,714132
11276.085849761963,27102292,1631.0,26388071,0,714221
11278.08888578415,27108001,2854.5,26393639,0,714362
11280.099997758865,27114194,3096.5,26399674,0,714520
11282.110661745071,27120512,3159.0,26405809,0,714703
11284.125931739807,27126824,3156.0,26411948,0,714876
11286.136988162994,27132902,3039.0,26417884,0,715018
11288.145496606827,27139078,3088.0,26423920,0,715158
11290.156529903412,27145158,3040.0,26429838,0,715320
11292.162493944168,27151112,2977.0,26435649,0,715463
11294.178276777267,27157318,3103.0,26441689,0,715629
11296.189061403275,27161423,2052.5,26445695,0,715728
11298.20012140274,27165416,1996.5,26449581,0,715835
11300.210724115372,27171035,2809.5,26455080,0,715955
11302.222066164017,27175175,2070.0,26459120,0,716055
11304.232907295227,27181402,3113.5,26465195,0,716207
11306.243727445602,27184465,1531.5,26468192,0,716273
11308.255516052246,27189392,2463.5,26472988,0,716404
11310.262554645538,27195154,2881.0,26478586,0,716568
11312.273909330368,27201427,3136.5,26484708,0,716719
11314.284920692444,27207459,3016.0,26490567,0,716892
11316.295570373535,27212780,2660.5,26495767,0,717013
11318.30947303772,27218544,2882.0,26501381,0,717163
11320.320237398148,27224663,3059.5,26507339,0,717324
11322.33107972145,27230893,3115.0,26513412,0,717481
11324.3414645195,27237169,3138.0,26519538,0,717631
11326.352348804474,27243385,3108.0,26525592,0,717793
11328.363606929779,27246786,1700.5,26528901,0,717885
11330.374712228775,27251334,2274.0,26533327,0,718007
11332.38224363327,27257595,3130.5,26539432,0,718163
11334.393347024918,27263603,3004.0,26545286,0,718317
11336.404308319092,27269797,3097.0,26551327,0,718470
11338.412873029709,27274559,2381.0,26555967,0,718592
11340.424023866653,27280463,2952.0,26561714,0,718749
11342.434970617294,27286593,3065.0,26567671,0,718922
11344.445952653885,27292745,3076.0,26573662,0,719083
11346.456728458405,27295811,1533.0,26576661,0,719150
11348.46832704544,27301707,2948.0,26582387,0,719320
11350.482907772064,27307851,3072.0,26588362,0,719489
11352.493648767471,27314053,3101.0,26594398,0,719655
11354.504800319672,27320345,3146.0,26600538,0,719807
11356.514062404633,27326467,3061.0,26606521,0,719946
11358.52788567543,27332653,3093.0,26612557,0,720096
11360.538524150848,27338701,3024.0,26618428,0,720273
11362.549570560455,27345022,3160.5,26624572,0,720450
11364.560299158096,27351173,3075.5,26630567,0,720606
11366.561872243881,27357343,3085.0,26636560,0,720783
11368.572776317596,27363467,3062.0,26642534,0,720933
11370.583888292313,27369756,3144.5,26648653,0,721103
11372.594470024109,27375893,3068.5,26654645,0,721248
11374.60539674759,27381617,2862.0,26660213,0,721404
11376.608050823212,27387829,3106.0,26666261,0,721568
11378.618837594986,27394213,3192.0,26672477,0,721736
11380.634261846542,27399757,2772.0,26677859,0,721898
11382.64593410492,27402686,1464.5,26680712,0,721974
11384.656867980957,27407603,2458.5,26685498,0,722105
11386.667664289474,27413823,3110.0,26691553,0,722270
11388.678202152252,27419707,2942.0,26697285,0,722422
11390.689190149307,27425303,2798.0,26702749,0,722554
11392.701926231384,27431231,2964.0,26708521,0,722710
11394.713308811188,27437115,2942.0,26714263,0,722852
11396.729374885559,27440017,1451.0,26717087,0,722930
11398.736886501312,27445896,2939.5,26722804,0,723092
11400.747827768326,27452049,3076.5,26728785,0,723264
11402.758769989014,27455964,1957.5,26732587,0,723377
11404.769641637802,27461948,2992.0,26738426,0,723522
11406.780734300613,27466387,2219.5,26742746,0,723641
11408.791902542114,27471453,2533.0,26747686,0,723767
11410.802856445312,27477319,2933.0,26753412,0,723907
11412.81371831894,27483608,3144.5,26759524,0,724084
11414.824439048767,27489605,2998.5,26765356,0,724249
11416.827018976212,27495094,2744.5,26770709,0,724385
11418.838434934616,27498334,1620.0,26773862,0,724472
11420.850175857544,27503678,2672.0,26779071,0,724607
11422.85162806511,27509544,2933.0,26784786,0,724758
11424.859335899353,27515473,2964.5,26790562,0,724911
11426.87032365799,27521472,2999.5,26796406,0,725066
11428.881166934967,27527360,2944.0,26802145,0,725215
11430.894787311554,27533013,2826.5,26807665,0,725348
11432.901877880096,27539193,3090.0,26813672,0,725521
11434.912958621979,27545005,2906.0,26819330,0,725675
11436.923533916473,27549126,2060.5,26823349,0,725777
11438.934398889542,27555037,2955.5,26829122,0,725915
11440.946121454239,27560620,2791.5,26834565,0,726055
11442.958587646484,27564999,2189.5,26838830,0,726169
11444.969123601913,27571376,3188.5,26845051,0,726325
11446.97970199585,27576963,2793.5,26850492,0,726471
11448.990606307983,27581557,2297.0,26854961,0,726596
11451.001289844513,27587569,3006.0,26860812,0,726757
11453.015466451645,27593524,2977.5,26866630,0,726894
11455.02656173706,27599280,2878.0,26872245,0,727035
11457.037644386292,27605202,2961.0,26877994,0,727208
11459.04866719246,27611089,2943.5,26883727,0,727362
11461.059616088867,27616834,2872.5,26889312,0,727522
11463.06645321846,27622699,2932.5,26895017,0,727682
11465.077179431915,27628917,3109.0,26901082,0,727835
11467.088129520416,27635235,3159.0,26907256,0,727979
11469.099224090576,27641380,3072.5,26913243,0,728137
11471.11025762558,27647605,3112.5,26919318,0,728287
11473.120994567871,27653503,2949.0,26925062,0,728441
11475.131505966187,27659666,3081.5,26931059,0,728607
11477.1421251297,27665295,2814.5,26936561,0,728734
11479.153353691101,27670920,2812.5,26942032,0,728888
11481.164189577103,27674793,1936.5,26945805,0,728988
11483.177042722702,27679477,2342.0,26950348,0,729129
11485.188057899475,27685193,2858.0,26955943,0,729250
11487.1925137043,27691065,2936.0,26961677,0,729388
11489.203503131866,27695710,2322.5,26966212,0,729498
11491.212460756302,27700694,2492.0,26971054,0,729640
11493.223126649857,27706572,2939.0,26976761,0,729811
11495.227765798569,27712019,2723.5,26982062,0,729957
11497.238842964172,27717980,2980.5,26987879,0,730101
11499.246080875397,27723535,2777.5,26993301,0,730234
11501.25846862793,27729271,2868.0,26998863,0,730408
11503.269510507584,27735398,3063.5,27004830,0,730568
11505.280081272125,27741323,2962.5,27010588,0,730735
11507.290711164474,27747017,2847.0,27016120,0,730897
11509.307009220123,27753194,3088.5,27022096,0,731098
11511.311277389526,27759403,3104.5,27028148,0,731255
11513.323833942413,27763527,2062.0,27032173,0,731354
11515.334866046906,27766922,1697.5,27035468,0,731454
11517.347889661789,27772043,2560.5,27040446,0,731597
11519.348893165588,27777874,2915.5,27046141,0,731733
11521.360306501389,27783578,2852.0,27051701,0,731877
11523.371063947678,27789256,2839.0,27057239,0,732017
11525.38208580017,27794784,2764.0,27062615,0,732169
11527.393137216568,27800889,3052.5,27068552,0,732337
11529.40423297882,27806797,2954.0,27074316,0,732481
11531.415217638016,27810028,1615.5,27077463,0,732565
11533.428189992905,27815408,2690.0,27082707,0,732701
11535.443476200104,27821299,2945.5,27088437,0,732862
11537.454324960709,27826536,2618.5,27093507,0,733029
11539.45564365387,27831362,2413.0,27098213,0,733149
11541.466593027115,27837319,2978.5,27104002,0,733317
11543.477407455444,27843158,2919.5,27109677,0,733481
11545.487906455994,27848697,2769.5,27115068,0,733629
11547.490463256836,27854734,3018.5,27120948,0,733786
11549.502291679382,27861066,3166.0,27127132,0,733934
11551.513028144836,27867377,3155.5,27133263,0,734114
11553.52558541298,27873559,3091.0,27139288,0,734271
11555.526818037033,27879138,2789.5,27144723,0,734415
11557.537589788437,27885198,3030.0,27150621,0,734577
11559.550735473633,27891435,3118.5,27156692,0,734743
11561.562061786652,27897750,3157.5,27162836,0,734914
11563.57328748703,27903840,3045.0,27168787,0,735053
11565.584405899048,27910065,3112.5,27174855,0,735210
11567.595263004303,27916362,3148.5,27180968,0,735394
11569.606248617172,27922631,3134.5,27187082,0,735549
11571.61495089531,27928747,3058.0,27193042,0,735705
11573.621627092361,27934921,3087.0,27199046,0,735875
11575.630149126053,27941111,3095.0,27205087,0,736024
11577.64318728447,27947358,3123.5,27211163,0,736195
11579.64784693718,27953350,2996.0,27216987,0,736363
11581.662193059921,27959582,3116.0,27223058,0,736524
11583.672773361206,27965483,2950.5,27228807,0,736676
11585.683678627014,27971674,3095.5,27234849,0,736825
11587.694128513336,27977419,2872.5,27240462,0,736957
11589.709254026413,27983372,2976.5,27246261,0,737111
11591.724724769592,27989156,2892.0,27251897,0,737259
11593.735780000687,27995206,3025.0,27257779,0,737427
11595.746615409851,28000477,2635.5,27262911,0,737566
11597.757793426514,28006531,3027.0,27268800,0,737731
11599.768796920776,28012480,2974.5,27274588,0,737892
11601.780732154846,28018675,3097.5,27280635,0,738040
11603.78205704689,28024578,2951.5,27286382,0,738196
11605.79675912857,28029797,2609.5,27291444,0,738353
11607.799128293991,28034891,2547.0,27296425,0,738466
11609.810402870178,28040550,2829.5,27301938,0,738612
11611.821937322617,28046782,3116.0,27307999,0,738783
11613.833012580872,28052764,2991.0,27313841,0,738923
11615.845198631287,28058609,2922.5,27319519,0,739090
11617.8562104702,28064944,3167.5,27325662,0,739282
11619.858574151993,28071132,3094.0,27331681,0,739451
11621.870017528534,28077425,3146.5,27337806,0,739619
11623.878158330917,28083578,3076.5,27343808,0,739770
11625.882329463959,28089763,3092.5,27349808,0,739955
11627.893337488174,28096119,3178.0,27356008,0,740111
11629.90427517891,28102248,3064.5,27361987,0,740261
11631.915291786194,28108500,3126.0,27368079,0,740421
11633.92623758316,28114898,3199.0,27374297,0,740601
11635.937129497528,28121232,3167.0,27380455,0,740777
11637.948091745377,28127341,3054.5,27386407,0,740934
11639.958996295929,28133540,3099.5,27392438,0,741102
11641.970014333725,28139869,3164.5,27398597,0,741272
11643.981801271439,28146134,3132.5,27404698,0,741436
11645.993040084839,28152219,3042.5,27410625,0,741594
11648.004043579102,28158479,3130.0,27416706,0,741773
11650.014649629593,28164835,3178.0,27422902,0,741933
11652.031201601028,28171143,3154.0,27429052,0,742091
11654.034942150116,28177515,3186.0,27435250,0,742265
11656.046956539154,28183555,3020.0,27441114,0,742441
11658.057609319687,28189758,3101.5,27447159,0,742599
11660.068500041962,28195927,3084.5,27453146,0,742781
11662.08433675766,28202206,3139.5,27459268,0,742938
11664.094906330109,28208152,2973.0,27465062,0,743090
11666.106530189514,28214288,3068.0,27471045,0,743243
11668.117887973785,28220158,2935.0,27476764,0,743394
11670.129805803299,28226411,3126.5,27482851,0,743560
11672.134079694748,28232150,2869.5,27488428,0,743722
11674.145584583282,28237069,2459.5,27493211,0,743858
11676.153713226318,28242069,2500.0,27498098,0,743971
11678.164697647095,28248347,3139.0,27504217,0,744130
11680.176003456116,28254163,2908.0,27509891,0,744272
11682.187456607819,28258212,2024.5,27513841,0,744371
11684.198578834534,28264435,3111.5,27519894,0,744541
11686.206648349762,28270705,3135.0,27526020,0,744685
11688.213479757309,28275871,2583.0,27531034,0,744837
11690.224387168884,28281298,2713.5,27536306,0,744992
11692.234946966171,28285185,1943.5,27540098,0,745087
11694.245788812637,28290630,2722.5,27545402,0,745228
11696.256388664246,28296537,2953.5,27551156,0,745381
11698.258138895035,28302403,2933.0,27556866,0,745537
11700.2689640522,28307792,2694.5,27562128,0,745664
11702.27966594696,28311733,1970.5,27565963,0,745770
11704.289464473724,28317316,2791.5,27571386,0,745930
11706.30004954338,28323227,2955.5,27577127,0,746100
11708.310744047165,28329220,2996.5,27582939,0,746281
11710.321925878525,28334353,2566.5,27587939,0,746414
11712.336942911148,28339682,2664.5,27593132,0,746550
11714.35271024704,28345471,2894.5,27598769,0,746702
11716.362125635147,28351379,2954.0,27604525,0,746854
11718.373028993607,28356995,2808.0,27609987,0,747008
11720.383789777756,28363158,3081.5,27615991,0,747167
11722.394767045975,28369342,3092.0,27622026,0,747316
11724.405694007874,28375635,3146.5,27628155,0,747480
11726.416320323944,28381657,3011.0,27634025,0,747632
11728.430829286575,28387863,3103.0,27640049,0,747814
11730.442014455795,28394116,3126.5,27646125,0,747991
11732.443435430527,28400447,3165.5,27652302,0,748145
11734.448165178299,28406320,2936.5,27658005,0,748315
11736.459228754044,28412358,3019.0,27663891,0,748467
11738.47012090683,28418636,3139.0,27670027,0,748609
11740.483068704605,28424890,3127.0,27676121,0,748769
11742.493673324585,28431135,3122.5,27682207,0,748928
11744.504522323608,28437261,3063.0,27688172,0,749089
11746.52049779892,28443372,3055.5,27694128,0,749244
11748.531140327454,28449643,3135.5,27700199,0,749444
11750.533535957336,28455855,3106.0,27706259,0,749596
11752.543914318085,28462072,3108.5,27712315,0,749757
11754.554943561554,28468292,3110.0,27718388,0,749904
11756.565511226654,28474619,3163.5,27724543,0,750076
11758.576541423798,28479890,2635.5,27729692,0,750198
11760.579962730408,28485643,2876.5,27735302,0,750341
11762.588058710098,28488908,1632.5,27738495,0,750413
11764.590141057968,28493307,2199.5,27742794,0,750513
11766.603615522385,28497300,1996.5,27746682,0,750618
11768.614654064178,28500901,1800.5,27750212,0,750689
11770.625757932663,28506404,2751.5,27755574,0,750830
11772.636485338211,28512304,2950.0,27761333,0,750971
11774.647158622742,28518240,2968.0,27767084,0,751156
11776.65858244896,28524318,3039.0,27773006,0,751312
11778.67358660698,28530520,3101.0,27779051,0,751469
11780.685070753098,28536525,3002.5,27784900,0,751625
11782.689269304276,28542265,2870.0,27790490,0,751775
11784.702921390533,28548258,2996.5,27796317,0,751941
11786.71780014038,28554063,2902.5,27801995,0,752068
11788.729221105576,28559860,2898.5,27807632,0,752228
11790.739710092545,28563269,1704.5,27810961,0,752308
11792.750447273254,28569041,2886.0,27816579,0,752462
11794.765525341034,28574840,2899.5,27822213,0,752627
11796.780148267746,28578404,1782.0,27825687,0,752717
11798.790914297104,28584264,2930.0,27831394,0,752870
11800.802368402481,28590396,3066.0,27837370,0,753026
11802.812933683395,28596639,3121.5,27843432,0,753207
11804.816289901733,28602778,3069.5,27849410,0,753368
11806.827812433243,28608902,3062.0,27855385,0,753517
11808.83887553215,28613068,2083.0,27859434,0,753634
11810.849661588669,28619398,3165.0,27865601,0,753797
11812.861407756805,28623214,1908.0,27869312,0,753902
11814.873975515366,28627015,1900.5,27873022,0,753993
11816.88624882698,28632261,2623.0,27878127,0,754134
11818.888750314713,28636625,2182.0,27882382,0,754243
11820.89983701706,28642820,3097.5,27888409,0,754411
11822.909623861313,28648933,3056.5,27894357,0,754576
11824.920320272446,28655190,3128.5,27900457,0,754733
11826.926162481308,28661352,3081.0,27906478,0,754874
11828.93676686287,28667454,3051.0,27912404,0,755050
11830.94784283638,28673445,2995.5,27918236,0,755209
11832.958786964417,28677165,1860.0,27921877,0,755288
11834.970014095306,28682429,2632.0,27927000,0,755429
11836.983441114426,28687891,2731.0,27932315,0,755576
11838.994613647461,28693550,2829.5,27937818,0,755732
11841.005868434906,28699391,2920.5,27943499,0,755892
11843.017011404037,28705275,2942.0,27949221,0,756054
11845.03028178215,28711131,2928.0,27954909,0,756222
11847.031069993973,28716338,2603.5,27959990,0,756348
11849.042288303375,28721157,2409.5,27964668,0,756489
11851.053829431534,28727138,2990.5,27970508,0,756630
11853.063839912415,28732516,2689.0,27975736,0,756780
11855.074382305145,28736333,1908.5,27979463,0,756870
11857.086862564087,28741912,2789.5,27984895,0,757017
11859.097856998444,28747402,2745.0,27990252,0,757150
11861.108800411224,28753133,2865.5,27995826,0,757307
11863.110961675644,28759065,2966.0,28001596,0,757469
11865.112965106964,28763209,2072.0,28005643,0,757566
11867.12857222557,28769530,3160.5,28011800,0,757730
11869.130295753479,28775797,3133.5,28017900,0,757897
11871.14299583435,28782108,3155.5,28024057,0,758051
11873.153898000717,28788217,3054.5,28030004,0,758213
11875.164508581161,28794484,3133.5,28036112,0,758372
11877.175854921341,28799811,2663.5,28041296,0,758515
11879.184640407562,28802857,1523.0,28044265,0,758592
11881.199126005173,28806616,1879.5,28047934,0,758682
11883.209875822067,28812878,3131.0,28054035,0,758843
11885.220613002777,28819213,3167.5,28060201,0,759012
11887.231539726257,28825393,3090.0,28066221,0,759172
11889.242319822311,28831470,3038.5,28072137,0,759333
11891.253174066544,28837648,3089.0,28078162,0,759486
11893.264638185501,28843791,3071.5,28084160,0,759631
11895.275882720947,28849996,3102.5,28090193,0,759803
11897.286941766739,28856105,3054.5,28096156,0,759949
11899.29868221283,28862253,3074.0,28102140,0,760113
11901.309330940247,28868595,3171.0,28108323,0,760272
11903.320153951645,28874834,3119.5,28114402,0,760432
11905.331089019775,28880939,3052.5,28120361,0,760578
11907.344196081161,28884934,1997.5,28124249,0,760685
11909.355104923248,28891117,3091.5,28130250,0,760867
11911.367239713669,28896111,2497.0,28135105,0,761006
11913.38176393509,28900130,2009.5,28139019,0,761111
11915.393633127213,28905970,2920.0,28144691,0,761279
11917.404243469238,28912187,3108.5,28150752,0,761435
11919.414853334427,28917147,2480.0,28155575,0,761572
11921.426329374313,28922925,2889.0,28161198,0,761727
11923.43831562996,28927408,2241.5,28165576,0,761832
11925.449211359024,28932991,2791.5,28171025,0,761966
11927.459881544113,28936844,1926.5,28174786,0,762058
11929.471122026443,28942523,2839.5,28180309,0,762214
11931.481860399246,28948687,3082.0,28186292,0,762395
11933.4929625988,28954783,3048.0,28192220,0,762563
11935.50366139412,28960779,2998.0,28198079,0,762700
11937.504601955414,28966622,2921.5,28203764,0,762858
11939.515801429749,28970638,2008.0,28207679,0,762959
11941.516132831573,28976540,2951.0,28213427,0,763113
11943.52763414383,28982351,2905.5,28219084,0,763267
11945.541513204575,28988271,2960.0,28224852,0,763419
11947.552635669708,28993137,2433.0,28229588,0,763549
11949.56327342987,28999076,2969.5,28235361,0,763715
11951.578669786453,29003949,2436.5,28240110,0,763839
11953.589312553406,29009428,2739.5,28245452,0,763976
11955.600975751877,29015213,2892.5,28251093,0,764120
11957.603898763657,29021397,3092.0,28257121,0,764276
11959.614748954773,29026250,2426.5,28261857,0,764393
11961.62249326706,29030087,1918.5,28265583,0,764504
11963.633438110352,29035553,2733.0,28270902,0,764651
11965.64440870285,29041207,2827.0,28276400,0,764807
11967.657872200012,29047165,2979.0,28282188,0,764977
11969.671011209488,29053030,2932.5,28287880,0,765150
11971.682635307312,29057166,2068.0,28291903,0,765263
11973.693948745728,29060499,1666.5,28295145,0,765354
11975.704643011093,29065953,2727.0,28300437,0,765516
11977.707422494888,29071804,2925.5,28306149,0,765655
11979.720082759857,29077620,2908.0,28311806,0,765814
11981.730914592743,29083567,2973.5,28317565,0,766002
11983.741614818573,29089440,2936.5,28323298,0,766142
11985.752547979355,29095390,2975.0,28329114,0,766276
11987.763213396072,29101615,3112.5,28335165,0,766450
11989.775376081467,29107963,3174.0,28341321,0,766642
11991.78644490242,29112493,2265.0,28345737,0,766756
11993.79733991623,29117067,2287.0,28350187,0,766880
11995.806500434875,29122847,2890.0,28355831,0,767016
11997.810261011124,29128648,2900.5,28361484,0,767164
11999.820963859558,29134901,3126.5,28367571,0,767330
12001.831965446472,29140977,3038.0,28373487,0,767490
12003.840564250946,29145294,2158.5,28377678,0,767616
12005.854005098343,29151485,3095.5,28383697,0,767788
12007.865070343018,29157759,3137.0,28389790,0,767969
12009.872101545334,29163813,3027.0,28395681,0,768132
12011.883461236954,29169981,3084.0,28401689,0,768292
12013.89437675476,29174798,2408.5,28406401,0,768397
12015.90538239479,29179334,2268.0,28410822,0,768512
12017.915913105011,29185196,2931.0,28416517,0,768679
12019.928555250168,29191113,2958.5,28422290,0,768823
12021.940031528473,29197087,2987.0,28428109,0,768978
12023.942207574844,29202878,2895.5,28433750,0,769128
12025.952909469604,29209058,3090.0,28439749,0,769309
12027.963866949081,29215242,3092.0,28445794,0,769448
12029.975906133652,29221385,3071.5,28451754,0,769631
12031.986458063126,29227716,3165.5,28457890,0,769826
12033.998836278915,29233623,2953.5,28463637,0,769986
12036.0122756958,29239593,2985.0,28469453,0,770140
12038.02276968956,29245930,3168.5,28475609,0,770321
12040.033706188202,29252063,3066.5,28481579,0,770484
12042.04430603981,29258094,3015.5,28487449,0,770645
12044.058454036713,29264323,3114.5,28493499,0,770824
12046.070302009583,29268936,2306.5,28497987,0,770949
12048.08089876175,29274854,2959.0,28503760,0,771094
12050.091649532318,29280658,2902.0,28509411,0,771247
12052.102367401123,29286921,3131.5,28515514,0,771407
12054.112894058228,29293234,3156.5,28521645,0,771589
12056.123810529709,29297388,2077.0,28525680,0,771708
12058.135073184967,29302950,2781.0,28531103,0,771847
12060.146016836166,29309206,3128.0,28537191,0,772015
12062.15684723854,29312923,1858.5,28540806,0,772117
12064.164488315582,29316698,1887.5,28544479,0,772219
12066.17563176155,29322186,2744.0,28549816,0,772370
12068.186277151108,29328535,3174.5,28555998,0,772537
12070.197073936462,29334218,2841.5,28561562,0,772656
12072.208224773407,29339103,2442.5,28566328,0,772775
12074.222584486008,29344992,2944.5,28572068,0,772924
12076.23346209526,29350919,2963.5,28577830,0,773089
12078.240208387375,29356924,3002.5,28583681,0,773243
12080.250831842422,29362819,2947.5,28589441,0,773378
12082.261373996735,29369075,3128.0,28595510,0,773565
12084.271956682205,29375184,3054.5,28601463,0,773721
12086.282509803772,29381338,3077.0,28607457,0,773881
12088.292966127396,29387596,3129.0,28613542,0,774054
12090.303339481354,29393925,3164.5,28619707,0,774218
12092.305077791214,29399804,2939.5,28625425,0,774379
12094.316230773926,29403040,1618.0,28628583,0,774457
12096.326354503632,29408818,2889.0,28634199,0,774619
12098.336922645569,29412001,1591.5,28637316,0,774685
12100.350006341934,29417807,2903.0,28642978,0,774829
12102.360807418823,29423906,3049.5,28648912,0,774994
12104.371481895447,29427259,1676.5,28652178,0,775081
12106.381961345673,29433130,2935.5,28657904,0,775226
12108.393376588821,29439329,3099.5,28663934,0,775395
12110.397353887558,29445499,3085.0,28669939,0,775560
12112.402039766312,29451776,3138.5,28676042,0,775734
12114.402412176132,29458098,3161.0,28682174,0,775924
12116.413053512573,29464302,3102.0,28688199,0,776103
12118.424671649933,29470367,3032.5,28694097,0,776270
12120.435267210007,29476455,3044.0,28700040,0,776415
12122.436993598938,29480660,2102.5,28704140,0,776520
12124.448369264603,29486451,2895.5,28709763,0,776688
12126.45154929161,29492482,3015.5,28715631,0,776851
12128.46194267273,29498567,3042.5,28721569,0,776998
12130.47245335579,29504772,3102.5,28727592,0,777180
12132.48294043541,29510891,3059.5,28733543,0,777348
12134.493406057358,29516812,2960.5,28739284,0,777528
12136.503964662552,29520593,1890.5,28742965,0,777628
12138.515016078949,29525501,2454.0,28747752,0,777749
12140.525511980057,29531150,2824.5,28753251,0,777899
12142.541248083115,29537101,2975.5,28759039,0,778062
12144.55186009407,29543122,3010.5,28764886,0,778236
12146.56251502037,29549174,3026.0,28770783,0,778391
12148.570660114288,29555292,3059.0,28776745,0,778547
12150.582917690277,29559920,2314.0,28781257,0,778663
12152.593554973602,29565448,2764.0,28786622,0,778826
12154.604350090027,29571345,2948.5,28792356,0,778989
12156.616122245789,29576823,2739.0,28797692,0,779131
12158.62723660469,29582763,2970.0,28803480,0,779283
12160.628323316574,29586909,2073.0,28807509,0,779400
12162.641357183456,29590316,1703.5,28810829,0,779487
12164.657783031464,29594380,2032.0,28814767,0,779613
12166.668875932693,29597981,1800.5,28818284,0,779697
12168.680152893066,29601623,1821.0,28821824,0,779799
12170.692949295044,29606085,2231.0,28826161,0,779924
12172.705211639404,29612453,3184.0,28832361,0,780092
12174.715736865997,29618316,2931.5,28838083,0,780233
12176.72565627098,29623502,2593.0,28843135,0,780367
12178.736209392548,29629254,2876.0,28848749,0,780505
12180.75057053566,29635354,3050.0,28854696,0,780658
12182.761005878448,29640838,2742.0,28860021,0,780817
12184.772143602371,29646854,3008.0,28865868,0,780986
12186.78665137291,29653118,3132.0,28871965,0,781153
12188.798220872879,29659364,3123.0,28878044,0,781320
12190.81186747551,29665475,3055.5,28884012,0,781463
12192.81373667717,29671523,3024.0,28889897,0,781626
12194.816447973251,29677672,3074.5,28895865,0,781807
12196.827140331268,29683888,3108.0,28901893,0,781995
12198.83755683899,29690098,3105.0,28907955,0,782143
12200.850274324417,29696164,3033.0,28913855,0,782309
12202.861914634705,29702453,3144.5,28919973,0,782480
12204.877702713013,29707214,2380.5,28924612,0,782602
12206.890605926514,29711973,2379.5,28929256,0,782717
12208.902942419052,29716427,2227.0,28933589,0,782838
12210.915663003922,29721898,2735.5,28938929,0,782969
12212.923334598541,29727822,2962.0,28944694,0,783128
12214.93534207344,29733659,2918.5,28950383,0,783276
12216.940972566605,29739666,3003.5,28956218,0,783448
12218.954206228256,29745793,3063.5,28962183,0,783610
12220.968364715576,29752117,3162.0,28968351,0,783766
12222.979885816574,29757859,2871.0,28973952,0,783907
12224.990547657013,29762832,2486.5,28978793,0,784039
12227.002016305923,29765678,1423.0,28981576,0,784102
12229.01337838173,29768505,1413.5,28984330,0,784175
12231.029942512512,29774447,2971.0,28990115,0,784332
12233.04088807106,29780519,3036.0,28996034,0,784485
12235.049851894379,29786769,3125.0,29002118,0,784651
12237.0534222126,29793126,3178.5,29008295,0,784831
12239.057817935944,29799301,3087.5,29014294,0,785007
12241.068702220917,29805376,3037.5,29020216,0,785160
12243.079887390137,29809473,2048.5,29024214,0,785259
12245.095036506653,29815625,3076.0,29030205,0,785420
12247.108542919159,29821905,3140.0,29036289,0,785616
12249.119225978851,29828199,3147.0,29042424,0,785775
12251.128254890442,29834329,3065.0,29048393,0,785936
12253.139255285263,29840613,3142.0,29054498,0,786115
12255.150006055832,29845098,2242.5,29058855,0,786243
12257.161092996597,29847985,1443.5,29061678,0,786307
12259.173549175262,29853618,2816.5,29067164,0,786454
12261.185498714447,29859911,3146.5,29073284,0,786627
12263.19697523117,29866208,3148.5,29079423,0,786785
12265.207402229309,29872404,3098.0,29085445,0,786959
12267.220137357712,29878426,3011.0,29091322,0,787104
12269.231963634491,29884702,3138.0,29097431,0,787271
12271.238050699234,29890959,3128.5,29103531,0,787428
12273.251250743866,29897216,3128.5,29109623,0,787593
12275.263093233109,29902852,2818.0,29115094,0,787758
12277.276839733124,29909141,3144.5,29121204,0,787937
12279.290388822556,29915380,3119.5,29127287,0,788093
12281.302538394928,29921481,3050.5,29133230,0,788251
12283.306028604507,29926621,2570.0,29138231,0,788390
12285.319665431976,29932737,3058.0,29144185,0,788552
12287.32220196724,29938853,3058.0,29150107,0,788746
12289.324876308441,29943266,2206.5,29154393,0,788873
12291.330513954163,29948313,2523.5,29159304,0,789009
12293.344733715057,29954281,2984.0,29165098,0,789183
12295.360382556915,29960478,3098.5,29171131,0,789347
12297.373992204666,29966640,3081.0,29177129,0,789511
12299.382379770279,29972350,2855.0,29182682,0,789668
12301.392992734909,29978360,3005.0,29188539,0,789821
12303.40556049347,29984036,2838.0,29194074,0,789962
12305.417357206345,29989405,2684.5,29199295,0,790110
12307.433088302612,29995571,3083.0,29205300,0,790271
12309.433467626572,29999932,2180.5,29209549,0,790383
12311.444425582886,30004687,2377.5,29214182,0,790505
12313.452137231827,30010625,2969.0,29219962,0,790663
12315.462709903717,30016846,3110.5,29226012,0,790834
12317.47473526001,30023028,3091.0,29232034,0,790994
12319.485842466354,30029015,2993.5,29237851,0,791164
12321.500653266907,30035313,3149.0,29243982,0,791331
12323.501207351685,30039623,2155.0,29248189,0,791434
12325.512209177017,30045151,2764.0,29253583,0,791568
12327.513806819916,30051011,2930.0,29259255,0,791756
12329.519033432007,30056902,2945.5,29264976,0,791926
12331.530533790588,30062752,2925.0,29270687,0,792065
12333.54030418396,30068433,2840.5,29276220,0,792213
12335.548801660538,30073839,2703.0,29281498,0,792341
12337.562457323074,30079681,2921.0,29287199,0,792482
12339.574743509293,30084345,2332.0,29291737,0,792608
12341.588863134384,30090161,2908.0,29297413,0,792748
12343.599590539932,30096143,2991.0,29303260,0,792883
12345.611953020096,30102316,3086.5,29309277,0,793039
12347.62237405777,30108340,3012.0,29315129,0,793211
12349.634356498718,30112267,1963.5,29318949,0,793318
12351.644792795181,30118329,3031.0,29324873,0,793456
12353.655760765076,30124094,2882.5,29330486,0,793608
12355.659541606903,30129954,2930.0,29336185,0,793769
12357.670182704926,30135617,2831.5,29341700,0,793917
12359.686677217484,30139259,1821.0,29345256,0,794003
12361.700012683868,30144576,2658.5,29350428,0,794148
12363.70824098587,30148912,2168.0,29354643,0,794269
12365.719517469406,30155193,3140.5,29360758,0,794435
12367.730798482895,30159269,2038.0,29364735,0,794534
12369.74599146843,30164578,2654.5,29369899,0,794679
12371.751962900162,30170521,2971.5,29375693,0,794828
12373.763123750687,30176424,2951.5,29381441,0,794983
12375.775480747223,30182750,3163.0,29387592,0,795158
12377.786170959473,30188473,2861.5,29393175,0,795298
12379.797916173935,30192775,2151.0,29397371,0,795404
12381.803563833237,30198944,3084.5,29403383,0,795561
12383.81587433815,30205281,3168.5,29409548,0,795733
12385.82947063446,30210199,2459.0,29414319,0,795880
12387.840723514557,30216031,2916.0,29420006,0,796025
12389.851640462875,30221254,2611.5,29425112,0,796142
12391.86407327652,30225728,2237.0,29429461,0,796267
12393.875570297241,30232008,3140.0,29435578,0,796430
12395.89043021202,30237656,2824.0,29441080,0,796576
12397.893555402756,30242710,2527.0,29445984,0,796726
12399.906132221222,30248750,3020.0,29451885,0,796865
12401.916635990143,30254961,3105.5,29457933,0,797028
12403.928495407104,30260826,2932.5,29463644,0,797182
12405.93903875351,30266811,2992.5,29469469,0,797342
12407.949674606323,30272599,2894.0,29475089,0,797510
12409.960674524307,30278718,3059.5,29481054,0,797664
12411.975355148315,30284845,3063.5,29487023,0,797822
12413.986181020737,30290994,3074.5,29493017,0,797977
12415.996890068054,30297301,3153.5,29499159,0,798142
12418.007648468018,30303583,3141.0,29505264,0,798319
12420.018241167068,30309626,3021.5,29511155,0,798471
12422.03037929535,30315744,3059.0,29517127,0,798617
12424.04162478447,30321851,3053.5,29523085,0,798766
12426.052267074585,30327799,2974.0,29528890,0,798909
12428.05990600586,30333682,2941.5,29534613,0,799069
12430.069889307022,30339355,2836.5,29540123,0,799232
12432.08071231842,30345081,2863.0,29545685,0,799396
12434.091322183609,30351268,3093.5,29551721,0,799547
12436.107212543488,30355911,2321.5,29556232,0,799679
12438.118481874466,30361956,3022.5,29562126,0,799830
12440.129699707031,30367025,2534.5,29567040,0,799985
12442.141229391098,30370687,1831.0,29570618,0,800069
12444.156966924667,30373484,1398.5,29573337,0,800147
12446.168048620224,30378441,2478.5,29578164,0,800277
12448.169743776321,30383701,2630.0,29583283,0,800418
12450.180728197098,30389449,2874.0,29588886,0,800563
12452.19187450409,30394978,2764.5,29594267,0,800711
12454.205850839615,30400181,2601.5,29599336,0,800845
12456.219511032104,30405144,2481.5,29604168,0,800976
12458.231745481491,30411258,3057.0,29610129,0,801129
12460.243364095688,30417302,3022.0,29616021,0,801281
12462.255672931671,30423497,3097.5,29622061,0,801436
12464.268957138062,30429767,3135.0,29628184,0,801583
12466.279703140259,30435149,2691.0,29633419,0,801730
12468.29210472107,30440049,2450.0,29638201,0,801848
12470.308393239975,30446198,3074.5,29644184,0,802014
12472.320251464844,30451539,2670.5,29649397,0,802142
12474.331469535828,30455735,2098.0,29653486,0,802249
12476.342695951462,30460959,2612.0,29658593,0,802366
12478.357683420181,30464388,1714.5,29661946,0,802442
12480.372473955154,30469507,2559.5,29666946,0,802561
12482.382075309753,30473307,1900.0,29670645,0,802662
12484.395409107208,30478366,2529.5,29675590,0,802776
12486.410992145538,30484441,3037.5,29681483,0,802958
12488.42296385765,30490630,3094.5,29687507,0,803123
12490.43352484703,30496843,3106.5,29693571,0,803272
12492.441024303436,30502947,3052.0,29699530,0,803417
12494.45312166214,30508955,3004.0,29705388,0,803567
12496.46438241005,30515038,3041.5,29711316,0,803722
12498.475377559662,30521331,3146.5,29717458,0,803873
12500.486938238144,30527504,3086.5,29723486,0,804018
12502.50027346611,30533565,3030.5,29729380,0,804185
12504.51192355156,30538831,2633.0,29734514,0,804317
12506.528076410294,30545005,3087.0,29740532,0,804473
12508.543881893158,30551044,3019.5,29746409,0,804635
12510.555176496506,30557130,3043.0,29752330,0,804800
12512.55593585968,30562216,2543.0,29757298,0,804918
12514.560170412064,30567949,2866.5,29762884,0,805065
12516.573154687881,30574032,3041.5,29768807,0,805225
12518.588444709778,30579891,2929.5,29774496,0,805395
12520.60190820694,30586055,3082.0,29780514,0,805541
12522.61217546463,30592262,3103.5,29786544,0,805718
12524.623989105225,30598363,3050.5,29792486,0,805877
12526.636881113052,30604579,3108.0,29798537,0,806042
12528.647294521332,30610863,3142.0,29804659,0,806204
12530.658476114273,30617162,3149.5,29810812,0,806350
12532.672747612,30623213,3025.5,29816708,0,806505
12534.684437990189,30629350,3068.5,29822697,0,806653
12536.698909521103,30635680,3165.0,29828861,0,806819
12538.7095348835,30641801,3060.5,29834809,0,806992
12540.720039844513,30647838,3018.5,29840684,0,807154
12542.730596780777,30654075,3118.5,29846755,0,807320
12544.74108839035,30660451,3188.0,29852962,0,807489
12546.746824502945,30666535,3042.0,29858907,0,807628
12548.757401227951,30672731,3098.0,29864958,0,807773
12550.767869234085,30679021,3145.0,29871079,0,807942
12552.779171466827,30685299,3139.0,29877195,0,808104
12554.789660930634,30691346,3023.5,29883074,0,808272
12556.800443649292,30697577,3115.5,29889131,0,808446
12558.811028957367,30703842,3132.5,29895245,0,808597
12560.822021007538,30709943,3050.5,29901194,0,808749
12562.834342241287,30716051,3054.0,29907155,0,808896
12564.845187664032,30722281,3115.0,29913207,0,809074
12566.849676847458,30728577,3148.0,29919335,0,809242
12568.852989912033,30734654,3038.5,29925267,0,809387
12570.863940000534,30740237,2791.5,29930702,0,809535
12572.87509894371,30744885,2324.0,29935224,0,809661
12574.886081695557,30749008,2061.5,29939225,0,809783
12576.89688706398,30755072,3032.0,29945124,0,809948
12578.910445928574,30761168,3048.0,29951052,0,810116
12580.922052383423,30767358,3095.0,29957068,0,810290
12582.935147285461,30773614,3128.0,29963161,0,810453
12584.947046518326,30779747,3066.5,29969113,0,810634
12586.96070766449,30785734,2993.5,29974933,0,810801
12588.975449323654,30791926,3096.0,29980948,0,810978
12590.98620223999,30798254,3164.0,29987106,0,811148
12592.992483615875,30804360,3053.0,29993041,0,811319
12595.00083565712,30810691,3165.5,29999214,0,811477
12597.013594865799,30816061,2685.0,30004431,0,811630
12599.028081178665,30821240,2589.5,30009479,0,811761
12601.03868317604,30827405,3082.5,30015477,0,811928
12603.05071902275,30831235,1915.0,30019201,0,812034
12605.062213897705,30837513,3139.0,30025314,0,812199
12607.07406783104,30843920,3203.5,30031564,0,812356
12609.082621574402,30850120,3100.0,30037600,0,812520
12611.087750196457,30856208,3044.0,30043517,0,812691
12613.091461658478,30862466,3129.0,30049618,0,812848
12615.102114915848,30868750,3142.0,30055739,0,813011
12617.113656282425,30874971,3110.5,30061794,0,813177
12619.125806808472,30881054,3041.5,30067744,0,813310
12621.127974033356,30887292,3119.0,30073790,0,813502
12623.13953757286,30893639,3173.5,30079951,0,813688
12625.150003671646,30899849,3105.0,30086006,0,813843
12627.160693645477,30906007,3079.0,30092003,0,814004
12629.16854596138,30912250,3121.5,30098089,0,814161
12631.182364940643,30918621,3185.5,30104300,0,814321
12633.19733762741,30924318,2848.5,30109818,0,814500
12635.197875738144,30929205,2443.5,30114586,0,814619
12637.208746671677,30935420,3107.5,30120639,0,814781
12639.223596096039,30941799,3189.5,30126853,0,814946
12641.231034994125,30947827,3014.0,30132729,0,815098
12643.241503953934,30953821,2997.0,30138552,0,815269
12645.252447605133,30960018,3098.5,30144580,0,815438
12647.254378318787,30966263,3122.5,30150653,0,815610
12649.267055511475,30972339,3038.0,30156588,0,815751
12651.276255846024,30978513,3087.0,30162604,0,815909
12653.287919044495,30984834,3160.5,30168766,0,816068
12655.298481702805,30991018,3092.0,30174776,0,816242
12657.299836397171,30997107,3044.5,30180704,0,816403
12659.31211233139,31003181,3037.0,30186623,0,816558
12661.32850599289,31009474,3146.5,30192755,0,816719
12663.341063976288,31015652,3089.0,30198750,0,816902
12665.345479249954,31021668,3008.0,30204593,0,817075
12667.35878610611,31027845,3088.5,30210616,0,817229
12669.369738817215,31034031,3093.0,30216651,0,817380
12671.383618116379,31040295,3132.0,30222741,0,817554
12673.39483165741,31046371,3038.0,30228680,0,817691
12675.406917333603,31052527,3078.0,30234675,0,817852
12677.418837308884,31058801,3137.0,30240789,0,818012
12679.430293798447,31065031,3115.0,30246862,0,818169
12681.443694353104,31071053,3011.0,30252714,0,818339
12683.454555034637,31075090,2018.5,30256641,0,818449
12685.465554952621,31081181,3045.5,30262589,0,818592
12687.477311849594,31087443,3131.0,30268681,0,818762
12689.485620260239,31093565,3061.0,30274662,0,818903
12691.49640917778,31099591,3013.0,30280519,0,819072
12693.507098674774,31105709,3059.0,30286465,0,819244
12695.52190899849,31111487,2889.0,30292068,0,819419
12697.53024816513,31117530,3021.5,30297962,0,819568
12699.530626058578,31123625,3047.5,30303907,0,819718
12701.543953895569,31129801,3088.0,30309927,0,819874
12703.556732416153,31136033,3116.0,30315985,0,820048
12705.568808078766,31142255,3111.0,30322046,0,820209
12707.57938504219,31147611,2678.0,30327248,0,820363
12709.589893341064,31151023,1706.0,30330573,0,820450
12711.601568222046,31156072,2524.5,30335502,0,820570
12713.61340713501,31162202,3065.0,30341449,0,820753
12715.624828100204,31167326,2562.0,30346438,0,820888
12717.639157533646,31172349,2511.5,30351328,0,821021
12719.653845310211,31178688,3169.5,30357501,0,821187
12721.661221265793,31184542,2927.0,30363197,0,821345
12723.67460346222,31190227,2842.5,30368746,0,821481
12725.68512415886,31196528,3150.5,30374904,0,821624
12727.697225809097,31202747,3109.5,30380959,0,821788
12729.709270238876,31208783,3018.0,30386851,0,821932
12731.71353983879,31214905,3061.0,30392829,0,822076
12733.717871427536,31221139,3117.0,30398896,0,822243
12735.729309558868,31227265,3063.0,30404852,0,822413
12737.740016698837,31233291,3013.0,30410715,0,822576
12739.750616312027,31239188,2948.5,30416457,0,822731
12741.761715173721,31244293,2552.5,30421430,0,822863
12743.772914886475,31249323,2515.0,30426342,0,822981
12745.787250995636,31252894,1785.5,30429818,0,823076
12747.79853272438,31259127,3116.5,30435881,0,823246
12749.8128387928,31265395,3134.0,30442004,0,823391
12751.818037748337,31268853,1729.0,30445370,0,823483
12753.830650568008,31274480,2813.5,30450842,0,823638
12755.833253622055,31280123,2821.5,30456348,0,823775
12757.84666800499,31286133,3005.0,30462186,0,823947
12759.859719276428,31292208,3037.5,30468105,0,824103
12761.863665103912,31296490,2141.0,30472268,0,824222
12763.875561952591,31301872,2691.0,30477491,0,824381
12765.890274524689,31307923,3025.5,30483358,0,824565
12767.9008603096,31314184,3130.5,30489438,0,824746
12769.902360200882,31319183,2499.5,30494310,0,824873
12771.915222644806,31324078,2447.5,30499110,0,824968
12773.928982019424,31330170,3046.0,30505050,0,825120
12775.940869808197,31336326,3078.0,30511023,0,825303
12777.946760177612,31342472,3073.0,30516997,0,825475
12779.95723080635,31348681,3104.5,30523037,0,825644
12781.969089746475,31355024,3171.5,30529199,0,825825
12783.981392145157,31359494,2235.0,30533568,0,825926
12785.992620944977,31363180,1843.0,30537170,0,826010
12788.00379395485,31368393,2606.5,30542254,0,826139
12790.007590055466,31374110,2858.5,30547807,0,826303
12792.01814699173,31380195,3042.5,30553720,0,826475
12794.025285482407,31386287,3046.0,30559650,0,826637
12796.035884857178,31392529,3121.0,30565728,0,826801
12798.04637503624,31398524,2997.5,30571559,0,826965
12800.057271242142,31403828,2652.0,30576729,0,827099
12802.068111419678,31409748,2960.0,30582500,0,827248
12804.079089164734,31416035,3143.5,30588625,0,827410
12806.090214967728,31422085,3025.0,30594520,0,827565
12808.10136795044,31428301,3108.0,30600562,0,827739
12810.103020906448,31434561,3130.0,30606658,0,827903
12812.11400794983,31440813,3126.0,30612723,0,828090
12814.130385160446,31446564,2875.5,30618323,0,828241
12816.14174747467,31452273,2854.5,30623876,0,828397
12818.15358877182,31458329,3028.0,30629767,0,828562
12820.16517663002,31463827,2749.0,30635126,0,828701
12822.1665225029,31469911,3042.0,30641051,0,828860
12824.17742061615,31475806,2947.5,30646790,0,829016
12826.18817782402,31481387,2790.5,30652228,0,829159
12828.199024438858,31486380,2496.5,30657083,0,829297
12830.207245349884,31491559,2589.5,30662125,0,829434
12832.21779870987,31497065,2753.0,30667475,0,829590
12834.228296518326,31500747,1841.0,30671077,0,829670
12836.240827083588,31505908,2580.5,30676114,0,829794
12838.25138258934,31510236,2164.0,30680331,0,829905
12840.261960744858,31515398,2581.0,30685365,0,830033
12842.272867202759,31519502,2052.0,30689370,0,830132
12844.277947187424,31524579,2538.5,30694328,0,830251
12846.289280414581,31530238,2829.5,30699827,0,830411
12848.301110744476,31534720,2241.0,30704188,0,830532
12850.31299328804,31540602,2941.0,30709908,0,830694
12852.324654579163,31546928,3163.0,30716074,0,830854
12854.34074640274,31551720,2396.0,30720741,0,830979
12856.352405548096,31557586,2933.0,30726451,0,831135
12858.36822271347,31563508,2961.0,30732220,0,831288
12860.37889122963,31569431,2961.5,30737969,0,831462
12862.38941860199,31575359,2964.0,30743729,0,831630
12864.400289058685,31579203,1922.0,30747468,0,831735
12866.411219358444,31584965,2881.0,30753072,0,831893
12868.42313671112,31590921,2978.0,30758873,0,832048
12870.435072898865,31596722,2900.5,30764530,0,832192
12872.438766241074,31602392,2835.0,30770057,0,832335
12874.454479694366,31607796,2702.0,30775316,0,832480
12876.465389251709,31612811,2507.5,30780206,0,832605
12878.468986988068,31618586,2887.5,30785831,0,832755
12880.480481624603,31624432,2923.0,30791513,0,832919
12882.494318962097,31630404,2986.0,30797298,0,833106
12884.5052921772,31636476,3036.0,30803211,0,833265
12886.517583608627,31640261,1892.5,30806916,0,833345
12888.528376102448,31646007,2873.0,30812523,0,833484
12890.540568828583,31650492,2242.5,30816889,0,833603
12892.551173210144,31656346,2927.0,30822565,0,833781
12894.56319475174,31660625,2139.5,30826740,0,833885
12896.570629119873,31665985,2680.0,30831942,0,834043
12898.584413766861,31672313,3164.0,30838117,0,834196
12900.596128463745,31678392,3039.5,30844055,0,834337
12902.607586860657,31684444,3026.0,30849949,0,834495
12904.609403848648,31690130,2843.0,30855482,0,834648
12906.621698617935,31696080,2975.0,30861272,0,834808
12908.62672495842,31702086,3003.0,30867121,0,834965
12910.640705108643,31707911,2912.5,30872808,0,835103
12912.651634454727,31713925,3007.0,30878675,0,835250
12914.662402629852,31719751,2913.0,30884355,0,835396
12916.67292022705,31725716,2982.5,30890160,0,835556
12918.685141324997,31731399,2841.5,30895688,0,835711
12920.701009511948,31737410,3005.5,30901554,0,835856
12922.703324079514,31743475,3032.5,30907432,0,836043
12924.71557545662,31749701,3113.0,30913476,0,836225
12926.727689266205,31755781,3040.0,30919385,0,836396
12928.742262840271,31761739,2979.0,30925186,0,836553
12930.75383067131,31767349,2805.0,30930668,0,836681
12932.762244462967,31773447,3049.0,30936609,0,836838
12934.774624109268,31779019,2786.0,30942035,0,836984
12936.787415266037,31785059,3020.0,30947909,0,837150
12938.80210518837,31791352,3146.5,30954041,0,837311
12940.805015325546,31797370,3009.0,30959909,0,837461
12942.81362605095,31801462,2046.0,30963913,0,837549
12944.826954603195,31807366,2952.0,30969646,0,837720
12946.838894367218,31813348,2991.0,30975461,0,837887
12948.851737260818,31819383,3017.5,30981322,0,838061
12950.86277461052,31825520,3068.5,30987291,0,838229
12952.875216960907,31830567,2523.5,30992200,0,838367
12954.878974676132,31835320,2376.5,30996825,0,838495
12956.879400968552,31841323,3001.5,31002668,0,838655
12958.892966032028,31847183,2930.0,31008367,0,838816
12960.902123212814,31852576,2696.5,31013624,0,838952
12962.915848731995,31858667,3045.5,31019562,0,839105
12964.927469968796,31864708,3020.5,31025427,0,839281
12966.929540395737,31870778,3035.0,31031339,0,839439
12968.940966367722,31876958,3090.0,31037369,0,839589
12970.952213048935,31883328,3185.0,31043584,0,839744
12972.955639839172,31889454,3063.0,31049556,0,839898
12974.970509290695,31895658,3102.0,31055621,0,840037
12976.982738494873,31901883,3112.5,31061697,0,840186
12978.997916698456,31908103,3110.0,31067746,0,840357
12981.010428667068,31914140,3018.5,31073618,0,840522
12983.01752781868,31920200,3030.0,31079509,0,840691
12985.033274412155,31926310,3055.0,31085450,0,840860
12987.045533895493,31932514,3102.0,31091487,0,841027
12989.057448863983,31937799,2642.5,31096646,0,841153
12991.071166038513,31943898,3049.5,31102587,0,841311
12993.084743261337,31950023,3062.5,31108577,0,841446
12995.088020563126,31955448,2712.5,31113847,0,841601
12997.099751710892,31961408,2980.0,31119644,0,841764
12999.123758077621,31967166,2879.0,31125233,0,841933
13001.13592839241,31973335,3084.5,31131229,0,842106